ALMLA	IN
HWFG	VB
LIPMN	NNP
HXLJWT	NN
HWLLIM	JJ
1,776	CD
ABZRIM	NN
FQWPIM	JJ
WQMNIM	NN
NWGDIM	JJ
MXPFIM	VB
PLJWT	NN
HWFR	VB
KPIWT	NN
CARLJWN	NNP
MJIL	VB
HTLQXH	VB
MTXRIM	NN
BWTIW	ZVL
LBNWNIT	JJ
SPQ	NN
SPR	NN
AWKZBW	VB
QWRCIM	VB
BIRWT	NN
SPI	NNP
MRKZM	NN
SPD	VB
MRKZI	JJ
SPG	VB
FIJTIT	JJ
BXINWT	NN
IXL	VB
XPC	NNT
QFWRWT	VB
DWBRI	NNT
IXD	IN
MSWNPIM	VB
IEILH	JJ
JMPLRIM	NN
HTPTXWT	NN
NFALT	VB
IXS	NN
FJIINBK	NNP
CRKIHM	NN
BAIRNWBH	NNP
JNQ	NNT
FLJIM	NN
CIBWR	NN
TENIQ	VB
6791	CD
KLLM	NN
MXTRT	NN
KLLI	JJ
KLLH	VB
QWFR	VB
KLLW	VB
MIDLSBWRW	NNP
TQWPWT	NN
MTAPFRT	VB
CWJJW	VB
MIIGE	JJ
BEJ	VB
FIRTW	NN
BEL	NNT
EDKWNIM	NN
XDWT	JJ
AMRIQAI	JJ
ITARK	VB
BED	IN
BKIRWT	JJ
BWBWT	NN
RFP	NNP
49	CD
IQCWR	VB
ARWKT	JJT
MZLNW	NN
LHJEWT	VB
BET	IN
ITARX	VB
EMNWAL	NNP
ANJWAN	NNP
NPGFW	VB
GLGWLIM	NN
INHLW	VB
BIRT	NNT
MIIXLT	VB
BIRH	NN
SJWDNJIALI	JJ
ECBIM	NN
IZKWR	NNP
BIRD	NNP
IISWRIM	NN
LALTR	RB
NWKXIWT	JJ
GRR	VB
HWLMWT	JJ
GRP	VB
MWKNIM	VB
MJWRPWT	JJ
TPRH	VB
EIRK	NN
KNISTM	NN
MANIIRWT	NN
NJIITW	NN
BIIJS	NNP
GRM	VB
HMWNIWT	JJ
GRI	NNP
HXJAH	NN
MPRC	NN
BDIQWT	NN
MFABIM	NN
SWDWT	NNT
MPRF	NN
NIGFH	VB
PIQWD	NNT
MPRJ	VB
MAWLCT	JJ
HLWWIH	NN
ANJWNIWS	NNP
HLM	NN
HLL	NNP
HLK	VB
HTABDWTW	NN
PIQWX	NN
HLH	PRP
BXRH	VB
BJX	RB
MLIWNR	NN
HLA	MOD
DIMWIIM	NN
MELIWT	NN
FJN	NN
EWLMN	NN
EWLMM	NN
FJG	NNP
TTGIIS	VB
EWLMH	NN
WIDWIIM	NN
PRNST	NNT
EWLMW	NN
FJX	NN
GBWHWT	JJ
MSQNWT	NN
BWXR	VB
HTPTXWIWT	NN
057	CD
051	CD
052	CD
HNAH	NN
LDMIIN	VB
AGTNWR	NNT
PRWANI	JJ
HWZRMW	VB
HMFKW	NN
MPRIK	VB
XSWT	NN
MQPIDH	VB
GPRIS	NNP
QSMH	NN
FWFIQ	NNP
NXFDW	VB
QWPCIM	NN
99	CD
98	CD
BAWT	JJ
PEILWTW	NN
91	CD
90	CD
93	CD
92	CD
95	CD
94	CD
96	CD
FKBTI	JJ
BARNS	NNP
HGIFH	VB
EZBW	VB
HSDRT	NNT
RBIEIT	JJ
EDH	NN
EDI	NNP
EDN	NNP
IMWT	NNT
LMH	QW
FPTWT	NNT
MJIP	NN
LMN	IN
EKFWWIT	JJ
EZBH	VB
LMD	VB
BICWR	NNT
LIRWT	NN
DWRWTIW	NN
FLBI	NNT
HTAWFFWT	NN
FERI	NNT
FERH	NN
HGDRTK	NN
HGDRTH	NN
LFWB	VB
FERW	NN
BICWE	NNT
LFWN	NN
ESQIM	NN
DPI	NNT
RFWT	NNT
LF	NNP
MTBJAT	VB
HFQEWT	NN
LB	NN
LA	RB
LN	NN
LM	NNP
LK	VB
LH	NNP
ZMINIM	JJ
LW	IN
PALQW	NNP
MXAH	NN
MMWFK	JJ
LHCJRP	VB
SNJH	NNP
LX	JJ
A	NNP
GMLAIM	NN
QWMIQAIM	NN
IAPFR	VB
IIFWMH	NN
ZIKRWNI	NN
TBWDD	VB
MSPQIM	VB
AIFWR	NNT
FNWTIW	NN
MXWSN	VB
HTNDND	VB
DAQWWRT	NNP
MIWEDWT	VB
FNWTIH	NN
AIFWM	NN
QRQE	NN
EJWP	JJ
EJWR	JJT
MWMXH	NN
DWBRT	NN
IXIDWTIHM	NN
MNHLIM	NN
PNW	VB
PNI	NNT
PNH	VB
MNHLIW	NN
LHPR	VB
EWBDI	NNT
EWBDH	NN
HIFGI	JJ
ITRWNWT	NN
KTBTK	NN
NERWT	NN
AIABQ	VB
LETIM	RB
RNSANS	NN
DLDWL	NNT
IKRIEW	VB
QSJLIJW	NNP
KPSR	NNP
XPR	NNP
ATNIIM	JJ
PRANCSQH	NNP
NHNIM	VB
DWLPIN	NNP
EICBH	VB
EWBDT	VB
LHFTLJ	VB
MXIIBT	VB
FIEI	JJ
PRQI	NNT
LHFTLB	VB
MFPXTWNIM	NN
ALIMH	JJ
MRWWIX	VB
BXFAI	RB
NTNIHW	NNP
TKNWN	NN
MPLIA	VB
BDIQH	NN
IIFMH	VB
TKWNWTIHM	NN
RMSW	VB
RFWTH	NN
GRRW	VB
NTRMIM	VB
MRQ	NN
MCWDT	NNT
MWCRI	NNT
MWFBIM	NN
FINWI	NN
MRH	JJ
MWFBIH	NN
XRPH	NN
DRIIB	NNP
MRD	NN
PQD	NN
HIGD	NN
GANDI	NNP
MRB	DT
NHRG	VB
NTMLAH	VB
MKLWL	NN
RGILIM	JJ
KWES	JJ
APS	CD
APP	VB
BRITH	NN
NENW	VB
API	NNP
ITSWS	VB
APL	NNP
APM	NN
IAPFRW	VB
AXRI	IN
FIQWMH	NN
AWSJRLIH	NNP
HBHIRH	VB
HEMSH	NN
LINHRJ	NNP
NIBAW	VB
MWLD	NN
ENIINI	NNT
2,500	CD
HBHIRW	VB
NSTIIMH	VB
ALKSNDR	NNP
MCBT	NNT
MWCBWT	VB
IZMH	VB
MWGBRT	JJ
HWKIX	VB
ISWD	NN
HPSQH	NN
MXZWR	NN
MDLILH	NNP
NAJS	NNP
MXZWT	NN
IZMW	VB
MFMEWTIWT	JJ
MTRWPP	VB
MIFXQ	NN
TBIET	NNT
GWRLIWT	JJ
ALQJRWNI	JJ
XWBTW	NN
DWAGIM	VB
MDAIGWT	VB
XWBTM	NN
HSMQTI	VB
MKWNIT	NN
MEDIP	VB
TBIEH	NN
IBIEW	VB
EWPR	NNP
MMDIWT	JJ
MSIIE	VB
NWJLIM	VB
TPSID	VB
HPCCT	NNT
RWWIIM	VB
RAIIH	NN
IBRXW	VB
HADRT	NNT
HTMRDWT	NN
TPSIQ	VB
BRIAIM	JJ
BRLINAIT	JJ
RAIIT	NNT
FWTQH	VB
MBWJX	NN
MWSEIM	VB
HTRIE	VB
AIGRWP	NN
AIMPRSIWNISJIIM	JJ
APIQ	NNP
XIZWI	NN
FBEWT	NNT
MQWJET	JJ
GWPTW	NN
PLG	NNP
MDINTIIM	JJ
FRIRWTIT	JJ
NKWNWTM	NN
MLAKWTIT	JJ
DBQIM	NN
PWRNWGRPI	JJ
MNIBH	VB
PJMIM	NN
XLWDIM	JJ
MSKIM	VB
THWWH	VB
SED	NN
NIQX	VB
DBQIT	NN
LERWK	VB
BHTIIXSWT	IN
NIQS	NNP
KSPIWT	JJ
CRWT	NN
BJWX	JJ
CRWP	JJ
HCJIIDWTH	NN
KWXH	NN
FMALIT	JJ
BJWN	NN
BJWI	NN
KWXN	NN
HAMIN	VB
FMAL	NN
ITMID	VB
NRTEWT	VB
MLWNAI	NN
HINDIT	JJ
QWNG	NNP
HCMDWT	NN
FWWDI	JJ
ILDWTW	NN
HWCGH	VB
XWDFI	NNT
ECRH	VB
MBNH	NN
ILDWTN	NN
ECRW	VB
PTQIM	NN
TMCA	VB
MJAPISIWT	JJ
JPILIM	NN
DIPLWMJI	JJ
HINDIM	NN
SGNWN	NN
PWRMALIT	JJ
TXBWRH	NN
LHTPNWT	VB
WLDISLB	NNP
MIKL	NNP
MQWR	NN
HRXIQH	VB
ETWDWTIH	NN
MILIWNIM	CD
MQWM	NN
AWIB	NN
LHTMNWT	VB
SEWDIM	NN
LPRWQ	VB
SEWDIH	NNP
RAIWTIH	NN
ANGLIH	NNP
HSKIM	VB
CXQWQW	NN
LWTR	NNP
TSMWNT	NNT
LPRWF	VB
ANGLIT	NN
LPRWE	VB
SEWDIT	JJ
EQWBIM	JJ
HTXZQH	VB
NEDR	JJT
KWPR	NN
GWSMN	NNP
HNHIGH	VB
MMKR	NNT
LHWBIL	VB
AWMDN	NN
LGIJIMIT	JJ
SNIPIM	NN
QLASI	JJ
QWMC	NN
AJWN	NNP
HPREH	NN
TARI	NNT
QHW	VB
AIRE	VB
GIWWN	NN
AIRH	VB
AIRI	JJ
MKHN	VB
SBLN	NN
PWCCW	VB
PGIWN	NN
TARX	VB
LHIEFWT	VB
AXRAIM	NN
PWNQCIWNLIT	JJ
FWNA	VB
MRQMI	NNT
EITWNAI	NN
SWPRMRQJ	NN
FWNI	NN
FWNH	JJ
MEWLH	JJ
LGIJIMIWT	JJ
IDIHM	NN
MEWLM	RB
LIWBWFIC	NNP
200	CD
NBXRTW	NN
TWRWT	NN
MRWKZ	JJ
MWFLMT	JJ
CEIRWT	JJ
MAWD	MOD
MNHAJN	NNP
QICWNI	JJ
MAWS	JJ
MRGWE	NN
MAWT	CDT
MIWTRWT	JJ
PAFISJIM	NN
QWNIM	VB
4.00	CD
TEWZH	NN
KRJISIM	NN
TSRIJIM	NN
ZXL	NN
JXINH	NN
LRWM	NNP
LRWC	VB
ADMTH	NN
PAFISJIT	JJ
ADMTM	NN
HTNCXWT	NNT
GBWRH	NN
LPJR	VB
LAPFR	VB
HFKIL	VB
MCWIIM	JJ
HFKIB	VB
ELBWNWT	NN
MCWIIN	JJ
ALMH	NNP
DIIHJSW	NNP
AWGWSJ	NNP
NFKX	VB
ZGWGIWT	NN
MCUX	NNP
MTLBJ	JJ
NFKR	JJ
MTNQF	NN
BHXLJ	RB
ENIINIT	JJ
HFQPTW	NN
ALMNJ	NN
MWKT	JJT
DMH	NN
SWKN	NNT
SWKM	VB
DMM	NN
XWRFWT	NNT
MSDRWN	NN
FMEWN	NNP
DMW	MOD
GLADIW	NNP
TLMID	NN
NWCXW	VB
GZEIIM	JJ
MJWT	NN
LKRSM	VB
MTWNWT	JJ
SIBWB	NN
QLPIWT	NN
MJWS	NN
AWFPZH	VB
FDWT	NNT
AWFPZW	VB
SIBWT	NN
RWCIM	VB
LDAWG	VB
MGIE	VB
KDLQMN	RB
MSMK	NN
MGIB	VB
MFXQIH	NN
HPELT	NNT
SRJNI	NNT
MZBX	NNT
MILIJNJI	JJ
HWQL	VB
XRF	VB
MIEARI	NNP
IXZRW	VB
XAGBI	NNP
BWXN	VB
HPELH	NN
XRP	IN
HWEMDH	VB
RGILWT	JJ
KAFR	IN
HFTWLLW	VB
LHIZHR	VB
ASUA	NNP
MTXDFT	VB
MBQR	NN
NGSW	VB
NPTXW	VB
PSX	NNP
IIZHRW	VB
MBQF	VB
HBDN	NNP
PSQ	NNT
XIKITM	VB
HNA	NNP
HBJXT	NNT
HNC	NNP
MQBILWT	JJ
BWRSWT	NN
BCD	IN
HNH	RB
NLXMW	VB
HNM	AGR
MTMSRWT	VB
FIGEWN	NN
BRIKT	NNT
EDKWNI	NNT
KSPIIM	JJ
HTEWRRH	VB
XTK	NN
TIZWT	NN
251	CD
GSWT	NN
QIWMW	NN
101	CD
MTXZH	VB
IWQRTIT	JJ
MLXH	NNP
HTBJA	VB
FGRIRWT	NNT
SDIN	NN
PWMBI	NN
QIWMM	NN
EIDWD	NNT
QIWMH	NN
HWGNT	VB
HRFH	VB
MFABIH	NN
SRJ	NN
SRI	NNP
SRN	NN
LZQWP	VB
MNDJIM	NN
MKWER	JJ
MTRGFT	VB
SRT	JJT
BMIFRIN	MOD
HRFW	VB
IXIDI	JJ
LNJWE	VB
RIINALDW	NNP
LHCBIE	VB
NELM	VB
XICWNIT	JJ
GWBRIM	JJ
RIKJR	NNP
NSBL	JJ
SWBIIJIIM	JJ
NML	NN
RIFIWN	NNT
MWQD	NN
FHH	VB
NXITT	NNT
BIJAW	VB
BIJAH	VB
CLXT	NN
NXITH	NN
GIXWK	NN
QLSIT	JJ
FWQD	VB
13.11	CD
HWLQWMB	NNP
LIGLI	JJ
AIREH	VB
BINIIM	NN
AIREW	VB
ARZI	NNT
HPIKT	NNT
NWBET	VB
HWKRZ	VB
IDWEWT	JJ
BRKTW	NN
KWXM	NN
TDEK	VB
CCIM	VB
MFME	NN
MINISJR	NNP
HEDIPW	VB
NMXQ	VB
MFMX	VB
SIMPJWMJI	JJ
DIPLWMJIIM	JJ
PNSIH	NN
MFMR	NNT
PNSIM	NN
BRKTI	VB
EBD	VB
BNWIH	VB
NALCIM	VB
AWRAL	NNP
MPDUL	NNP
EBH	JJ
KTIBTW	NN
BWCEH	VB
LIBRLIZM	NN
EBR	VB
TWPX	NNP
QRIJRIWNIM	NN
ALPI	CDT
TFLWBWT	NNT
MEIINIW	NN
XIZWQ	NNT
FLFWM	RB
AIID	NNP
XIZWR	NN
KLKLIIM	JJ
TBJIX	VB
XARBI	NNP
PWRFT	VB
IIRAH	VB
PWRFW	VB
DRK	NN
MMLKTIT	JJ
IIRAW	VB
MIQPTMWNH1	ZVL
QIFWR	NN
WWTIQIM	NN
KTWBIM	JJ
DRF	VB
MWRA	NN
EISQWT	NN
MFWPR	JJ
PDGWGIT	NN
HXLH	VB
DWDIM	NN
DRWMI	JJ
HXLT	NNT
AZWRI	NNT
HXLW	VB
IIMLJ	VB
LHTIR	VB
MSIIRIM	VB
GMLAWT	NN
EITWI	NN
EITWN	NN
QCWBH	JJ
LTQN	VB
NDRF	VB
QWNSJNJINSQW	NNP
ALBRJW	NNP
FRIR	NNP
MLGLGIM	VB
QRWI	VB
FRIM	NN
BLGAN	NN
JRWWLIAN	NNP
MXWQQ	NN
QRWB	JJ
FRID	NNP
HWSPH	NN
CXQ	VB
HPSIDW	VB
ACJLH	NN
FGRTI	JJ
QHILTI	JJ
KLFHM	JJ
KLFHN	JJ
QBIEH	NN
KLFHI	JJ
034,000	CD
QBIET	NNT
TNWHL	VB
KLFHW	JJ
KWRXH	NN
LMEFH	RB
DNWWR	NNP
yyRRB	yyRRB
KWPIM	VB
XJWPIM	NN
SWPIT	RB
MBWCEIM	VB
AXIHWD	NNP
HACT	NNT
MNHL	NNT
ENII	NNT
ENIN	NN
METH	RB
LLXWC	VB
AIMPRSIWNIZM	NN
ZMNW	NN
LLXWF	VB
LCRWK	VB
DAGH	NN
IXTRW	VB
SBLWTIH	NN
IFQLW	VB
FWQDIM	VB
PWPWLRI	JJ
SMDR	NN
QJWRZH	NNP
LFER	VB
PQIDWT	NN
053	CD
HIBXRWTM	NN
BRIJNIH	NNP
FKNH	NN
NPCE	VB
MBWSSIM	JJ
TMWH	JJ
HSTDRWT	NN
EZIBTW	NN
MFMETIWT	JJ
HGIRTM	NN
AIGRWT	NNT
HTBWNNWT	NN
GNBH	NNP
EIRIH	NN
EZIBTM	NN
MWNIWT	NN
HFGI	NNT
MXLIP	VB
FKNW	NN
DMQH	NN
FWRRT	VB
MTXW	VB
IWEC	NN
JABH	NNP
PSIM	NN
BRIRH	NN
RWTM	NNP
NHPK	AUX
MPH	NN
MPI	IN
MFM	RB
MPT	NNT
MPR	VB
HWXLPH	VB
PRANQPWRJ	NNP
TWRT	NNT
MKFIRIHM	NN
MKLIM	NN
HFTWLLWT	NN
NLQX	VB
TXZIQ	VB
HESIQ	VB
MWNX	NN
AWPWRJWNISJI	JJ
MWNW	VB
AIWMM	NN
BRQT	NNP
AIWMI	NNT
AIWMH	JJ
MWNJ	NNP
CEQN	JJ
MWNH	VB
NFKRIM	JJ
CPWI	JJ
MWND	NNP
MWNE	JJ
MEWWT	JJ
CPWN	NN
BQFTW	NN
NALC	VB
EMIM	NN
PLFTINIM	NN
EZRIH	NNP
MIMWNW	NN
HCETW	NN
TWKNITW	NN
01,050	CD
MWBNWT	VB
HCETM	NN
HCETI	VB
LXLWM	VB
5,191	CD
HTXIIBW	VB
HTABDWTIT	JJ
JIWJWT	NN
PLFTINIT	JJ
EMIT	NNP
LXLWF	VB
LHWEID	VB
HTQBLW	VB
EWRK	NNT
PWLIJI	JJ
SLAX	NNP
IEFW	VB
HKRTW	NN
QLIPWRNIH	NNP
NWRIT	NNP
PRMIH	NN
IWMIIM	NN
AZRX	NN
EWRR	VB
EWRP	NN
HTQBLH	VB
DEH	NN
BIQWRIM	NN
FXQIM	NN
GLZR	NNP
HWKN	VB
AWQIINWS	NN
LIMWDIW	NN
EMWQWT	JJ
APQJIWWIWT	NN
XZWNWTIW	NN
TWKKI	NNT
PWRENWT	NN
DRWQR	NNP
XLASQW	NNP
XFTI	VB
NWCRH	VB
REIWNIT	JJ
HCLXWT	NN
LHXZIR	VB
LHXZIQ	VB
HIPLJWTM	NN
MCBIM	NN
TXNWT	NN
MIWTRT	JJ
TLMWD	NNP
MTNGDI	NNT
IWBAW	VB
MFWSE	JJ
MTELMIM	VB
MWBLET	NN
LAIJH	RB
TAWLWGIH	NN
HXLJNW	VB
NISH	VB
BWWDAI	RB
FPTW	NN
HWRDH	NN
IEMDW	VB
MECMH	NN
HTHPK	VB
LALC	VB
AWLIMPIWT	JJ
IRDNH	NNP
IRDNI	JJ
MECMT	NNT
SLIMZIANWB	NNP
HWRDT	NNT
LIMWDIH	NN
NISW	VB
HJLT	NNT
FPTM	NN
NTQBLH	VB
E	NNP
RAIIN	VB
MLIAH	NN
ERBIIM	JJ
HXLPT	NNT
SPIRT	NNT
HXLPH	NN
FWXRRW	VB
ZWLWJWXIN	NNP
MLIAT	NNT
RFWIWT	NN
W.	NNP
NTQBLW	VB
LHSPID	VB
MBLI	IN
SPGW	VB
HWLKT	VB
PNITI	VB
JWENT	VB
MFPXWT	NN
HPIC	VB
LHSPIQ	VB
SPGH	VB
MMWQMIM	VB
IPXT	VB
DEKH	VB
ALQLS	NNP
HWCEW	VB
MWFLMWT	VB
IAMRW	VB
MINIBWS	NN
APILW	MOD
MCJBR	JJ
FRIRWTIWT	NN
TWWK	NN
TKWNWT	NN
GWRIWN	NNP
HQMT	NNT
FNATW	NN
HKNSNW	VB
HWCIAH	VB
WIFINSQI	NNP
BHSTMK	IN
FWKNWT	VB
BAMCEWT	IN
AWLPNIM	NN
LHTIIDD	VB
AWLPNIH	NN
GWLDFJIIN	NNP
KLKWTH	NNP
DWGMAWT	NN
HKFR	NN
MQUM	NN
AWKL	NN
XDIRT	NNT
MEJIM	JJ
XDIRH	JJ
SMIWN	NNP
FRBWB	NNT
811	CD
LPEMIM	RB
IWECIM	NN
FWLXNM	NN
HWEMDW	VB
APFRWTH	NN
ZBWBIM	NN
MMWQM	VB
HCHRWT	NN
MTNCL	VB
NXFPWT	VB
HCJMCM	VB
LHWRWT	VB
92.2	CD
IIEDH	VB
EFTH	VB
DWGLIM	NN
AWJWPIH	NN
MTQIIM	VB
AIPH	QW
NIDWNW	VB
GLIMH	NN
ILDWT	NN
BHIRIM	JJ
SNIPI	NNT
HQFBH	NN
ERWKIM	VB
NIDWNH	VB
TQP	VB
FWLL	NN
DWKNIM	NN
IFLBW	VB
FWLI	NNT
PIQRIH	NNP
FWLJ	VB
EZWTH	NN
MIBXN	NN
HXZQT	NNT
PLJINH	NN
HXZQH	NN
AMCEIM	NN
SWBLIM	VB
MEWRIM	VB
TPAWRWT	NNT
ZIRWZ	NNT
DIWNIM	NN
FWLP	VB
DIWNIH	NN
MTWN	JJ
MTWK	IN
LPQPQ	VB
XQIINIM	NN
SGRW	VB
PEWLT	NNT
RBNIH	NN
PEWLH	NN
MRWMH	JJ
SGRH	VB
RBNIM	NN
301	CD
FWAPWT	VB
XFWPIM	JJ
JEWTW	NN
FIERN	NN
XTIRTH	NN
EDT	NNT
JWBI	NNT
JWBH	JJ
BRCLWNH	NNP
JWBE	VB
HNDSH	NN
HWTIRW	VB
HNDST	NNT
BWEWT	NN
MNWXIM	JJ
PRWPWRCIWNLIT	JJ
JEWTI	NN
MIJWSIS	NN
RWB	DT
HSDRI	NNT
MWCAI	NNT
RWE	NN
GIBWRT	NNT
MCWR	NN
MGLM	VB
MWNJRI	JJ
MN	IN
MI	QW
MH	QW
MEIZIM	VB
TIAJRLI	JJ
MT	VB
MCWA	NN
MS	NN
MR	NNP
RWX	NN
MWCAT	VB
RWZ	NNP
MCWI	VB
MPRSM	VB
RGIFWT	JJ
XWGI	NNT
KLWAIM	VB
XFBWNN	NN
HWBA	VB
IXPF	VB
QCWWT	NN
ILDI	NNT
ILDH	NN
HRGFTM	NN
HRGFTI	VB
PRQLIJ	NNT
JBRIH	NNP
ALWMINIWM	NN
SIWRIM	NN
QNDIIM	JJ
HTIIBFWT	NN
SIPRW	VB
HBQIEH	VB
GIFT	NNT
HLWWIWT	NNT
PRSWMIM	NN
AWSJRLIIM	JJ
AWPNIIM	NN
IIMSR	VB
PRSWMIW	NN
BIQWRW	NN
BMHRH	RB
HFQENW	VB
IIALCW	VB
GIFH	NN
SIPRH	VB
MTBDXIM	VB
RIINWLDS	NNP
HWFEH	VB
DLILH	JJ
LDLG	VB
WWDAI	NN
2.1	CD
TWQNH	VB
MDWIQ	JJ
MTNHLIM	VB
XIJH	NN
XTN	NNT
XTM	VB
LIMDW	VB
LIMDT	VB
IKXIF	VB
ASWR	VB
LHQPIA	VB
BWJWT	NN
HCLXT	NNT
FFINSQI	NNP
HZKRTI	VB
GWWEH	VB
HGDIL	VB
ITPQD	VB
NJENT	VB
PUT	NNP
NIIDT	NNT
FRIJH	NN
ASWN	NN
IMQUA	NNP
BAW	VB
HNXH	NN
5,836	CD
BAR	NNT
SJND	NNP
BAQ	NNP
RNDI	NNP
IQWTIAL	NNP
TTEWRR	VB
WEIDH	NN
XWDFIT	JJ
TWCAWT	NN
MTXIL	VB
ITQFW	VB
BAL	NNP
LQXIM	NN
BAH	JJ
BAI	NNT
APJUA	NNP
MXIRIM	NN
RHIJIM	NN
SIIEH	VB
TRWEH	NN
LHZHIR	VB
GAWLH	NNP
LFWJ	VB
RWKLIM	NN
0891	CD
SIIEW	VB
LHKRIE	VB
XWFIM	NN
HWNXW	VB
XRKI	NNT
FNATM	NN
HPELTM	NN
JWBWT	JJ
ACBE	NN
STM	MOD
LIQWIIM	NN
MTGLH	VB
FILMNW	VB
MSBIRIM	VB
RCINIT	JJ
STR	NN
TBQR	VB
WWED	NN
XWFIW	NN
HWGLH	VB
JWBWL	NNP
HPELTW	NN
AICMT	NNP
NCX	NNP
SWKNIM	NN
TWLDH	NN
LWKSMBWRG	NNP
TFE	CD
NCR	NNP
BINWNIT	JJ
BNWT	NN
NCI	JJ
MWZMN	VB
TWRMIM	VB
RFAI	VB
IGAL	NNP
NWQJT	VB
LID	IN
AXIZTH	NN
FNT	NNT
GRWEH	JJ
ARNWLD	NNP
EWLIM	NN
ADWJ	NNP
MWSD	NN
PRSIM	NN
IFMF	VB
MRIBH	NN
ADWM	JJ
LIT	NN
TPISH	NN
DMWNIT	JJ
ADWQ	RB
MSQRN	JJ
ASWNWT	NN
FNA	VB
PWGE	JJ
TRNGWLT	NN
BRAWNING	NNP
MPSIDWT	JJ
LHBJIX	VB
FNI	CDT
FNH	NN
FLJWNW	NN
AIRGN	VB
MIDIT	JJ
XWLIIT	NNT
MXBRIM	NN
MGWIIS	JJ
MXWDDIM	JJ
TXTIT	NN
XWLQW	VB
SIKWII	NNT
IIWWDEW	VB
MHSSIM	VB
PRDSNWT	NN
MTQBLWT	VB
QBR	NN
DIRT	NNT
TXZWR	VB
EIQRIIM	JJ
RIBAWNDIM	NN
ZDWNIWT	JJ
XICWNIWT	JJ
MPKUL	NN
QBE	VB
AWWIRIT	JJ
MSGRT	NN
RCIXWT	NN
MIQWX	NN
MFSH	VB
XFIM	VB
KAB	NN
IIFAR	VB
MQIPIM	VB
QANJIM	NN
DPNSIWWI	JJ
HGIBW	VB
ETIDH	NN
ETIDM	NN
KAN	RB
LSBWL	VB
XMQMQH	JJ
LHABQ	VB
ARGNJINAI	JJ
ETIDW	NN
WEUR	NNP
EFINW	VB
RHB	NNP
NTED	VB
PSIKWLWGIT	NN
IIFWMN	NN
MQWBLIM	JJ
TIGRH	NN
XIZWRIW	NN
PRIWN	NN
TIGRM	VB
IFIRWT	RB
TRBWTIIM	JJ
DMWIWT	NN
ICIE	NN
RCIWNLISJIM	JJ
FWMRIM	VB
ZEIR	JJ
DWQJRINH	NN
TBWANH	VB
MTWNH	JJ
AIRWPIT	JJ
PRWPWRCIWNALI	JJ
RPWBLIQAIT	JJ
GBRI	JJ
IINQJW	VB
PSIKIAJRIIM	JJ
HFG	NN
GBRH	VB
FBUK	NNP
SALMINH	NNP
NWPIM	NN
RGWEIM	JJ
QPIDBIN	ZVL
RDIQLIIM	JJ
PWQWS	NN
QWSMJIQH	NN
NKPW	VB
16.11	CD
LPWRR	VB
ARBEH	CD
MIPGFIM	NN
ARBET	CDT
BGIN	IN
LXN	NN
HANS	NNP
ZITWNI	NNP
HWPEH	NN
AMPIRI	JJ
AWTIWT	NN
MIIFM	VB
IFWLMW	VB
KEWSH	JJ
MBJIX	JJ
MITIT	JJ
PRIMIJIWWI	JJ
AWPJIT	JJ
KIBWD	NNT
GBRT	NN
NFENIM	VB
KPWL	JJ
SPIRH	NN
HTABDWT	NN
ATM	PRP
TEBWRH	NN
QLIBR	NN
ATH	PRP
HMWNIIM	JJ
MERK	NN
ATR	NN
MERB	NN
AWSJRIH	NNP
KPWT	NN
TEFIITIWT	JJ
HFPETW	NN
QWRAT	NN
MEWRBWTW	NN
IXFWB	VB
7491	CD
NAPWLI	NNP
ADRIKLWT	NN
HWTIR	VB
2	CD
HWTRTM	NN
PWMBIT	JJ
NIQWL	NNP
KBIFIM	NN
LIIQRS	NNP
TMWMF	VB
AIRANIIM	JJ
BGIDH	NN
HFGTH	NN
BKR	NNP
WAQWM	NN
RISSW	VB
XMNIIH	NNP
LWWIITW	NN
NERI	NNT
NERH	NN
NERK	VB
MIQWMH	NN
IFIRH	JJ
FWWQIM	NN
FKLI	JJ
LLMWD	VB
MWLIKH	NN
KHIM	JJ
HIKL	NN
RWZN	NNP
HIKN	QW
TFKIL	VB
RWZI	NNP
RWZH	NNP
DGWL	JJ
ITMWK	VB
TARIKIM	NN
KFRWN	NN
MTPTX	VB
GWLDFMIDJ	NNP
NWQFWT	JJ
MBED	IN
JWRNIR	NN
HIDRDR	VB
LCPWT	VB
CIIRIM	NN
ZABI	NNP
WEDWTIW	NN
RIINHARDJ	NNP
PCWEIM	NN
MRBIT	DT
IHDWTW	NN
MWCHRT	VB
MRBIM	VB
GMWL	NN
IHDWTM	NN
TWKIX	VB
QWRQ	NNP
XNQW	VB
AWHLIM	NN
LHQRIN	VB
QCHW	NN
EMWS	NNP
LXZWT	VB
EMWQ	JJ
HTXNNW	VB
NWRWWGIT	JJ
LHQRIB	VB
DPNIM	NN
XWLLH	VB
SJR	VB
EMWD	NNT
NWRWWGIH	NNP
HPSDIM	NN
TRBWT	NN
MCWPWT	VB
HDPS	NN
RGBH	NNP
ECMTI	VB
IXIDIM	NN
IBIAW	VB
SINNTI	VB
MIICGIM	VB
RIBIT	NN
MDENIM	NN
NQEH	VB
EDTI	JJ
IEDH	NN
MIWXDWT	JJ
AILCW	VB
MFWDRT	VB
HIKWN	NN
ATMWL	RB
HTNGFWIWT	NN
BWQE	VB
SJH	VB
MXZQT	VB
SIQSRS	NNP
RWQDIM	VB
MEWRRWT	VB
FWRWTIHM	NN
JMWNH	VB
AIRWPIIM	JJ
NICLW	VB
TFLWMIHM	NN
HXMIRH	VB
IRWQIM	NN
WI	NNP
RXCH	NN
ARIALH	NNP
EBWTWT	NN
IFIBTH	NN
NICLH	VB
MRGIEH	JJ
MWSIPIM	VB
QWNSRBJWRIWN	NN
QILWP	NN
XJIPT	NNT
CIIDIM	NN
MWNGWLI	JJ
JWNIACI	NNP
HWRFE	VB
BLEDI	IN
XJIPH	NN
HWRFH	VB
MRKINH	VB
BHIR	JJ
BRXH	VB
AMRIQAIIM	JJ
GWLDN	NNP
PRJNRIM	NN
XIH	JJ
XII	NNT
JJRSJN	NNP
CBWRIIM	JJ
IDQWR	VB
IWCAT	NNT
NIGWSIM	NN
XIQ	NNT
IWCAW	VB
HTRGFWT	NN
FQLIM	NN
LHFBIT	VB
FMIIMIWT	JJ
ITMWDDW	VB
MBJL	VB
HPKW	VB
DWNIH	NNP
GWRL	NN
LSDR	VB
GWRN	NNP
DNWN	NNP
QWJL	VB
RWZNBRG	NNP
MGLMIM	VB
HWLID	VB
XMTW	NN
LIIFB	VB
MERKWNIHM	NN
GILITI	VB
SBIBWTIH	NN
TMUT	NN
PTRWNWTIHM	NN
ELIIH	NN
LWWNJINIM	JJ
XQR	VB
LMXRT	RB
SDRI	NNT
KTBTW	NN
MAKZBIM	VB
SDRN	NN
SSGWNIT	JJ
SWERWT	JJ
BMSGRT	IN
TERWKH	NN
NWTNWT	VB
FIAM	NN
FIAN	NN
FIAH	NN
IRWQWT	JJ
SDRT	NNT
MITRI	NNT
MTWKNNT	JJ
IPSIQ	VB
HISJWRIT	JJ
GWBRT	VB
MHLKIW	NN
MIKAL	NNP
IIEFH	VB
MTWQCB	JJ
MWRXQ	NN
HISJWRIH	NN
TMWRH	NN
IRIXW	NNP
IPSID	VB
ANWKI	JJ
BDIQT	NNT
RLWWNJI	JJ
AINW	RB
KWTB	VB
GNAQ	NNP
ALRGIT	JJ
MPEL	NN
AIFWRW	NN
KWTL	NN
HLWWIIT	NNT
QWNWJCIWT	NN
IWECW	NN
AING	NNP
PSNTR	NN
MKTB	NN
HLWWIIH	NN
MQWWIM	VB
AINM	RB
AINN	RB
AINH	RB
AINI	RB
AINK	RB
LWZ	NNP
NRKF	VB
HQPDTW	NN
HCDQH	NN
XWPFWT	NNT
HJQWN	NNP
MGRWT	VB
IDIDIM	NN
FWJR	NN
MWPQ	VB
FWJP	JJ
IFTLW	VB
GIDWLM	NN
NWJS	NNP
AMWR	VB
IDIDI	NN
IDIDH	NN
AMWT	NNT
8491	CD
IIXS	VB
NSIM	NNP
ALPIM	CD
FNAH	NN
LCLWE	VB
AWRXIM	NN
ANGLH	NNP
MTIM	NN
IDIDW	NN
NWJH	VB
AMWN	NN
NWJL	VB
TQCH	VB
LBJL	VB
TNWETW	NN
LHMCIA	VB
PRS	NN
TKLITH	NN
NXRCWT	RB
FAIPH	NN
MHLKIM	NN
QWL	NN
TKLITW	NN
ZWMN	VB
PWTXIM	VB
ALIM	JJ
FBIRH	NN
IIHNH	VB
NFWT	NNT
DANPRMLIN	NNP
RUG	NNP
ABNEL	NNP
DWALIWT	NN
NFWI	NN
HTEQFH	VB
IZQWP	VB
NMWK	JJ
BICWEI	NNT
HTIICBW	VB
BICWEN	NN
LFMWE	VB
LEQWB	VB
DII	NNP
TKLIT	NN
INSH	VB
PRGWN	NN
MFTNH	VB
GZENWT	NN
RPAL	NNP
EBRWN	NNP
LEQWR	VB
AWNIM	NN
LEQWP	VB
INSW	VB
NSIWN	NN
DHIRH	NN
FIJTIIM	JJ
IQBL	VB
DIQ	NNP
DIR	NNP
DIS	NNP
REIWNW	NN
XFPTI	VB
BIQWRT	NN
TXILH	RB
PXWTH	JJ
LHTKNS	VB
MSIQ	NNT
RWWIW	NNP
NXJPT	VB
HWGDRW	VB
LWD	NNP
MSIM	NN
TXILT	NNT
MEILH	NN
REIWNI	JJ
HTEKB	VB
HWFGW	VB
PRFNIM	NN
TWXLT	NN
AIDIAWLWGI	JJ
LXNK	VB
I	NNP
IRQ	VB
LIRJWT	NN
HKFIR	VB
IIFWTI	NN
IRW	VB
IRH	VB
IRI	NN
TXL	VB
HKFIL	VB
HQBLH	NN
IRD	VB
HWFGH	VB
MRKZIIM	JJ
QPSPBINKN	ZVL
PWR	NNP
PWS	NNP
FSWEH	JJ
MRKZIIH	NN
60,000	CD
HBXNH	NN
ARHUB	NNP
APSIM	NN
ETIDNW	NN
APSIQ	VB
APSIT	JJ
PEMIM	NN
MWJIWWBCIH	NN
PWL	NNP
MRKZIIT	NNT
HTPWRRWT	NN
LDQLM	VB
BNWTIHM	NN
BNWTIHN	NN
XLILH	MOD
HWDIIM	JJ
HFRAH	NN
HCLIX	VB
NAH	JJ
FIIKIM	JJ
LHBXIN	VB
HFTIIKW	VB
001,000	CD
TRBH	VB
NAW	MOD
MQWMIIM	JJ
SWLTM	NNP
BDIDWTW	NN
FALNW	VB
PJRIQ	NNP
BEIJT	NNT
AILWC	NN
AWNIBRSIJT	NNT
ELBWN	NN
PRFN	NNP
HLKWT	NN
PRFH	NN
XNIH	NN
PRFT	NNT
ALQJRWNIQH	NN
CEIRH	JJ
MHDRIN	NN
HCJIINW	VB
AWNIBRSIJH	NN
LHELWT	VB
IWGWSLWWIT	JJ
XRIP	JJ
TBWA	VB
NEIM	NNP
HRBW	VB
LHIXRC	VB
JIFJF	VB
MGMH	NN
LBBIIM	JJ
FQWEH	VB
FIERTI	VB
CIWR	NN
XRIF	NNP
HRBH	DT
SIJWNAIIM	JJ
IWGWSLWWIH	NNP
WIJLI	NNP
PIJWRI	NNT
2551	CD
TWCAWTIW	NN
NDWFIM	JJ
MWJLIM	NN
MWSQWWH	NNP
MWZKR	VB
CIWNIT	JJ
GWLI	NNP
CIWNIM	JJ
APWSJRWP	NNP
JISIIH	NNP
MTXILIM	VB
64	CD
TWCAWTIH	NN
TDIRAN	NNP
65	CD
LKN	CC
FLX	VB
AZRXIT	JJ
BQRB	IN
ARNWNH	NN
MWUM	NN
MWUL	NN
LLKT	VB
CNCNWT	NN
MTQDMIM	JJ
XLFIM	NN
HBITH	RB
DIIGW	NNP
GBWHIM	JJ
FLJ	NNT
FLM	JJ
FLL	VB
MIICGT	VB
FLA	RB
WWEDH	NN
FLB	NN
TIABQ	VB
FLD	NN
LEQL	VB
BWBH	NN
AIPFR	VB
FIWWQ	NN
AIRAN	NNP
XWLWN	NNP
LRQWD	VB
TWCRT	NN
PGIEWT	NN
MCLMWTIHM	NN
PRNCSQW	NNP
MWNEIM	VB
NWSPWT	JJ
MWSIPH	VB
HFTDLNW	VB
HIEDRWT	NN
RFLNIT	JJ
EWIN	JJ
MLWT	NNT
ANS	VB
TWBN	VB
QLJNW	VB
XICWNIIM	JJ
AWPCIWT	NN
MFQI	NNT
MFQL	NN
HTQPH	NN
RIALIZM	NN
ANARKIH	NN
WWEIDH	NN
PRWCWT	NN
MBWSST	JJ
JPFIM	JJ
XZWTW	NN
MCPWT	VB
LRFWM	VB
HXRIP	VB
HTQPT	NNT
MRFM	NN
RWD	NNP
KPRIHM	NN
BTWLI	NNT
TRBWTIWT	JJ
TWELT	NN
MPWXDIM	JJ
SAWNH	NN
CWMT	NNT
CWMX	NN
CWIIN	VB
MGWWN	JJ
XIDWF	NNT
LXIMH	NN
AMQWR	NNP
EIDKNH	VB
PASIWWIWT	NN
NA	NNP
NIHL	VB
LFQM	VB
NE	VB
BTMWRH	IN
IHLWMI	NNT
LFQP	VB
HWFKRW	VB
FIEWRI	NNT
NQ	NN
NR	NNT
NS	NN
IWRKB	VB
NW	RB
DXIPH	NN
FMXH	NNP
KIWM	RB
CNRT	NN
MQCWEWT	NN
HTARGNWIWT	NN
TBWNT	NNT
509	CD
SXIJT	NNT
LTMWK	VB
MEWDKNIM	JJ
CLSIWS	NNP
ZWRMIM	JJ
KIWR	NN
LGFR	VB
FMXT	NNT
LHPGIN	VB
IFRAL	NNP
PWRJRJIM	NN
LHPGIF	VB
IPAN	NNP
NBNH	VB
ELIWNH	JJ
TWRGM	VB
31.5	CD
JLPWNIM	NN
500	CD
HWDIT	JJ
FISWI	NNT
MBINIM	VB
LASWR	VB
FXWRI	NNT
XDFIMIFNIM	JJ
LMKWR	VB
FJIPT	NNT
AZL	VB
SKSWK	NN
SIDRH	NN
MIMWFN	NN
MLMIN	NN
MIMWFH	NN
IICWRW	NN
MWLH	NN
KWWIT	NNP
AIMTNI	JJ
EZR	NN
AXRT	JJ
MHPK	NN
TCLWM	NN
AZWRIM	NN
DACH	NNP
QIBWCI	JJ
MNPRDI	NNP
PINWI	NNT
HTAM	NN
MFXQI	NNT
MNHIG	NN
LHIGRM	VB
ARTWR	NNP
MFXQW	NN
RGFIT	JJ
MIICRT	VB
T.D.	NNP
IWRDWT	JJ
KWFI	NN
MSMRIM	NN
HRAWBNI	NNP
MMUN	NNP
QLINGR	NNP
GWRWDNH	NNP
AQDX	NN
MSWIMWT	JJ
MENIF	VB
TIEFH	VB
FKBH	NN
MWPIE	VB
NQBEIM	VB
KNWT	NN
RWXW	NN
RWXQ	NNT
NDKAIM	NN
TRD	NN
IWAL	NNP
CWPRI	NNT
IWAB	NNP
TIRFM	VB
CATM	NN
CATN	NN
BIGWN	NNP
MFTQWT	VB
HQPDTI	VB
RWXC	VB
RWXB	NN
NCIGIHM	NN
BIGWD	NN
TDMWR	NNP
FIBWCIM	NN
RWXH	NN
HIIT	AUX
XNWK	NNP
HGDLT	NNT
XNWN	NNP
HCIT	VB
DWNALD	NNP
IFIMW	VB
MFMIEIM	VB
AIRDINGN	NNP
FBWEIT	JJ
XNWQ	JJ
HPCIR	VB
BNIW	NN
IZWZ	VB
EBDH	VB
ABWT	NN
FBWEI	JJ
GBRIM	NN
NRXBWT	JJ
LPLG	VB
CIRWP	NN
NRTMT	VB
QARW	NNP
MSLWL	NN
NAPH	VB
1,053	CD
FMALN	NN
FMALI	JJ
TAWNH	NN
CRKNI	NNT
1,500	CD
XLMWNIT	NN
RMZIM	NN
RAFWNH	JJ
RAFWNI	JJ
WSJLND	NNP
ZILND	NNP
ASJRAJGIIM	JJ
MEIQH	VB
TAWNT	NNT
ECRWT	NN
LMLA	VB
MEMDM	NN
HWPKWT	VB
MFWLBWT	VB
RAIWT	NN
SEWD	NNP
IHWDH	NNP
NWGET	VB
LKAWRH	RB
EWMDT	VB
RAIWN	NN
AIIMN	NNP
WILIAMS	NNP
JRAWMWT	NN
XWBRT	NN
HRIWN	NN
WIDIAW	NN
IXID	JJ
GWLIANW	NNP
HEZH	VB
TQNI	NNT
NWFIM	NN
IEBWR	VB
GWPM	NN
PJRARQH	NNP
GWPW	NN
IXZIQW	VB
HTNGDH	VB
GWPR	NNP
FKNWTIH	NN
MLKWD	NN
96.4	CD
AIKPT	VB
XTIMTW	NN
APWDIM	NN
NIWZ	NNP
BWGRI	JJT
HFPLWT	NN
MFJXIM	NN
ITEFR	VB
MCWMCM	JJ
HTAQLMW	VB
QWLWNIWT	NN
FKIXIM	JJ
NAWM	NN
RIFWM	NN
IPCICW	VB
MSBIB	MOD
ASPNIM	NN
HXLJTW	NN
MWCUF	NN
QWDMIM	JJ
HIRRKIH	NN
PWRWMIM	NNP
QWDMIW	NN
AIRWPI	JJ
AIRWPH	NNP
MTWKNN	VB
GIRSAWT	NN
LHPQIE	VB
HXLJTM	NN
SPWRIM	JJ
JWRQI	JJ
QWDM	RB
ALBZ	NNP
LGRF	VB
MERIKIM	VB
XIWBI	JJ
HXLJTH	NN
QWDF	NN
PNIHM	NN
NKTBIM	VB
XWBTH	NN
NWXH	JJ
NJLW	VB
HNZILT	ZVL
HNCW	VB
GNQ	NNP
IMCAW	VB
MCWMCMIM	JJ
FWLIWT	JJ
BRIIJWN	NNP
BIGZ	NNP
AWGW	NNP
RAFWTW	NN
GNT	NNT
LWJW	NN
FMRNIT	JJ
THLWKH	NN
LWJH	NNP
TIPGM	VB
6	CD
NPLAH	JJ
IQWDMW	VB
RPWBLIQH	NN
AWJWNWMIH	NN
BRWDI	NNP
ESWQH	JJ
TPEL	VB
MNWCLIM	VB
XQLAIT	JJ
NRQMT	VB
XQLAIM	NN
TZMWRT	NNT
WILBWFBIC	NNP
AMSJRDM	NNP
AWMNM	RB
MPGF	NN
AILW	CC
AILT	NNP
MPGE	NN
MIQI	NNP
LXCH	NN
SGNIHM	NN
TSBWKT	NNT
MPGR	JJ
AILC	VB
LFLWJ	VB
FWQXTN	NNP
BARAN	NNP
AII	NNP
MWPLGT	JJ
AILN	NNP
MSIIM	VB
MKR	NN
FQJ	NN
FQI	NNT
XZITWT	NNT
FQL	NN
RDAI	NNP
NTINI	NNT
TWRNWIWT	NN
MWNJIPIWRI	NNP
FQE	VB
DWMINNJIT	JJ
JSIM	VB
MILWLIT	JJ
IRBW	VB
FWHH	VB
QWALICIWNI	JJ
MLWJF	JJ
FWHM	NNP
AWLDHAM	NNP
HBRWT	NN
MTKT	NN
PNSW	NNP
RICARD	NNP
BJWXWT	JJ
RKIM	JJ
ZWNH	NN
NWHL	VB
QILWMJRIM	NN
BRBF	NNP
PQIDIM	NN
NWHG	VB
MNCXIM	NN
SRWG	JJ
XNIKH	NN
NIILWN	NN
CWBET	VB
APGNISJAN	NNP
RWPAIM	NN
MTPRCIM	VB
SIPWRI	NN
MTAIM	JJ
XRDIM	NN
LWBIC	NNP
MWFMET	VB
LEJWP	VB
ZRE	NN
MZIQIM	NN
SIPWRW	NN
LEJWT	VB
ZRA	NN
ZRM	NN
LBNIM	JJ
LNHWG	VB
CRKI	NNT
WJW	NN
SIWEN	NN
MWCET	JJ
QDMW	VB
LMFWK	VB
HCDH	RB
QDMH	NN
HTNHGWTH	NN
JWRDNI	JJ
PLIJ	NN
PLII	NNP
HBANW	VB
AIWMIM	NN
AQDWXW	NN
IFKWN	VB
WRP	NNP
NTEQF	VB
FALWTIH	NN
MFRDW	NN
QPTMWNH1	ZVL
NSE	VB
XWCH	NN
HERWT	NNT
SWMK	NNP
ADIRWT	JJ
LKNS	VB
SWMN	VB
AIWMIW	NN
HPSDH	NN
MMFLWT	NN
MTLWWIM	VB
PWLIJIQAI	NN
QPSPBIN	ZVL
SBLNWTW	NN
XCWT	NN
LGMRI	MOD
MITMMIM	JJ
HPSDW	NN
BIJWII	NNT
EIQRW	NN
XFMLIIM	JJ
HMWCET	JJ
EIQRH	NN
EIQRI	JJ
NIMWQ	NN
MNWSBIC	NNP
PNWIIM	JJ
ATLJIM	NN
IPH	JJ
XINH	NN
XINM	NN
MXIIBIM	VB
NDIBIM	JJ
IPW	NNP
MZLM	NN
GWPRIT	NN
TLAWT	NN
RWBNW	NN
NGD	IN
NGE	NNT
TILXM	VB
HDS	NN
HDR	NNP
NGB	NN
HDP	VB
KSPRIT	NN
MAMIN	VB
NGH	NNP
CIIR	NN
LHWFIJ	VB
CIIN	VB
IIFWBIM	NN
LHQT	NNT
NGX	VB
HENQT	NNT
20.1	CD
16.30	CD
SMWAL	NNP
BMH	NN
PRDI	NNP
AWPRJIWWI	JJ
ATIAIZM	NN
PSWLT	NNT
PIINBRG	NNP
BMW	IN
FIRWTW	NN
MTNKRT	JJ
DWDTN	NN
GIBF	VB
NIQL	NNP
SHR	NN
GIBE	NNP
PSIKWMJRIWT	JJ
XRGW	VB
RCWP	JJ
AICIQ	NNP
MSKN	VB
HWAILW	VB
HWPEWT	NN
RCWN	NN
EBWDWT	NN
MSKT	NN
LHIXLC	VB
GZBR	NN
AWBD	JJ
TRBWTH	NN
MWJLWT	VB
MGE	NN
ANDRII	NNP
AWJWBIWGRAPI	JJ
RQJWR	NN
MGI	NNP
MPZR	VB
RWCH	VB
JRIJWRIH	NN
MCWQT	NNT
TFLWMIM	NN
HSTBKH	VB
ASJRJGI	JJ
LAMBR	NNP
GZR	NNT
LNW	VB
HISJWRIWGRPIH	NN
LQCR	VB
RFIMTW	NN
7.1	CD
MWWT	NN
HMFIKH	VB
MSIBT	NNT
IFIR	JJ
NFARIM	VB
LQCC	VB
GABDWLH	NNP
HMFIKW	VB
XLWMH	NN
IFIF	NN
GRINFJIIN	NNP
AIJIWT	NNT
LLMD	VB
JXWB	JJ
HWXDRH	VB
HTPWRRWTH	NN
PWCC	VB
PGFNW	VB
GRGWRI	NNT
HEWWIH	NN
IQIIM	VB
FMWTIHM	NN
PWCH	VB
LEBWD	VB
MIBCE	NNT
HTNQFWT	NN
HWRIHN	NN
XWCWT	NN
LMDTI	VB
TEMWLTH	NN
BWZ	NN
LPTWR	VB
HTXLTI	VB
LHKWT	VB
HWQET	NNT
AWPIINH	VB
29.90	CD
MPRSMIM	VB
MRQXT	NN
QFT	NN
CNWEIM	JJ
MTIIXST	VB
QFR	NN
MAZNM	NN
NKTBH	VB
FNIIM	CD
HMBWRG	NNP
QFH	VB
QFI	NNT
NMFK	VB
FNIIH	JJ
GINII	NNP
AFUP	NNP
NSERIM	JJ
TCIE	VB
TCIG	VB
MIGWWN	NN
HTQNT	NNT
HQIMW	VB
IWFBIM	VB
HSBH	VB
RMN	NNP
LFKWR	VB
TQRIT	NN
IMHRW	VB
HCLXNW	VB
MQWMI	JJ
KET	RB
HQIMH	VB
XFML	NN
MQWMM	NN
HSBR	NN
LNQWJ	VB
SILWN	NN
NHRGW	VB
MRDP	NN
LNQWM	NNP
MFWBCWT	JJ
HIDRDRNW	VB
SWGRIM	VB
WWIIS	NNP
PRIST	NNT
ABIW	NN
HWGI	NNT
FWERIM	NN
WWIIJ	NNP
ABIN	VB
WWIIN	NNP
ABIB	NN
BNWTIW	NN
75.90	CD
HCJRPH	VB
TPJWR	VB
TQPID	VB
RWXNI	JJ
HTQFRTI	VB
PEWLTW	NN
RAFWT	NNT
TRISIM	NN
HWLIDIIS	NNP
RAFWN	JJ
PEWLTM	NN
BHTAM	IN
PEWLTH	NN
MIWCRIM	VB
PFRNIM	NN
ICAW	VB
FJXH	NN
NMRCIM	JJ
NJWLI	JJT
M	IN
BIIRWT	NNP
AXIWT	NN
MXMMIM	VB
LHTBJA	VB
DWQJWRJ	NN
ICAH	VB
MDBRWT	VB
MFWEMM	JJ
HEID	VB
DRGH	NN
LHTPRNS	VB
IDWE	VB
PWRNWGRPIIM	JJ
NKTB	VB
NTRAH	VB
AMIRH	NN
RMPH	NN
01.00	CD
MXLIPIM	VB
MAMINIM	VB
LASQW	NNP
MTQPH	NN
AXR	JJ
MIJB	NNT
NIQWLSWN	NNP
AXT	CD
AXZ	VB
IECBW	VB
XMMH	NN
XBRTW	NN
QARLSRH	NNP
TRZH	NNP
MILIARDI	CDT
NIXWX	NN
AINJNSIWWIT	JJ
AXD	CD
MWAFM	VB
MZIQ	JJ
MWNFM	VB
HCJRPW	VB
MRCIM	NN
LHTERB	VB
WWDAWT	NN
MQLWT	JJ
MGRFH	NN
MQBL	VB
ITBCE	VB
MQWMWN	NN
QWRET	VB
AXRITW	NN
HDGFH	NN
MQWMWT	NN
NECBNW	VB
JIPWLIM	NN
BIWTR	MOD
LHTQFR	VB
CBWEIM	JJ
HSTBR	VB
HMGDLIT	NNP
PWXDIM	VB
IFWXRRW	VB
NQNSH	VB
IWRIM	VB
NSWGW	VB
LTSWS	VB
PLIATW	NN
AHRN	NNP
FMWAL	NNP
XBIT	NN
EISWQW	NN
NIKWI	NNT
GRZI	NNP
ENQI	JJ
BKDI	IN
GRZN	NN
WIILD	NNP
FIEIT	JJ
QNCLR	NN
MZX	NN
SEWDIIM	JJ
IWCA	VB
MWEDWNIM	NN
MZG	NNT
MAWKLSIM	VB
MZL	NN
BDLNIT	JJ
FWBTIM	NN
MGZRIM	NN
LNHL	VB
1,509	CD
7.30	CD
WGMN	NNP
MCIAWT	NN
311	CD
SWGIH	NN
BEIITIWT	NN
MWLWT	NN
PRIJIM	NN
PRQLIJWT	NNT
KPRIM	NN
PIDIWN	NN
ZIQTW	NN
GWRBIC	NNP
NWSH	VB
AMNI	NNT
NWSK	VB
BNWIIM	JJ
AMNM	RB
QWDFBIC	NNP
QRISJI	NNP
MWNJRIAWL	NNP
RKIST	NNT
FMLWTIHN	NN
NWSE	VB
ALPRD	NNP
NWSX	NNT
PWNQCIWNLIIM	JJ
RGFI	NNT
LHGDIR	VB
442	CD
NWSP	JJ
XWQQH	VB
AMNT	NNT
KNST	NN
AMNW	NN
LHEDIP	VB
XLWP	NNT
FQIM	NN
MRWWAN	NNP
XMIFIT	JJ
FQIT	NN
XMIFIM	CD
XLWC	NN
XLWM	NN
XLWN	NN
LIHNWT	VB
MIFXQI	NNT
AISMEIL	NNP
HRKBW	NN
CHBHB	JJ
EISWQ	NN
JRIJWRIALIT	JJ
BWSIM	NN
CBAWT	NNT
IBBWT	NN
HRKBH	NN
HRKBI	NNP
LHILXM	VB
QWAN	NNP
ABDH	NN
TMKH	VB
HNHIG	VB
NWKXI	JJ
MJBEWT	NN
MPGINIM	NN
NZRQW	VB
GIRWF	NNT
FTI	CDT
MXWLQ	VB
MSCWSJS	NNP
NWKXT	NN
ICRNW	VB
DIBWRW	NN
NKSP	JJ
HWLMT	JJ
HPKH	AUX
DIPNDRH	NNP
BSWP	RB
LAFR	VB
FIJWR	NN
TIJWL	VB
BPWMBI	RB
HISJWRIWT	JJ
MQWDF	JJ
CILCL	VB
GRIST	NNT
MIMWF	NNT
WWLWNJARI	JJ
CRKNIT	NN
XMF	CD
FERIIM	NNP
MIMWN	NN
MQRJE	VB
CRKNIM	NN
ECWMWT	JJ
GRISH	NN
MFQAWT	NN
XMW	NNP
XMQ	VB
FIKTBTI	VB
LHLN	RB
XMWFIM	JJ
06	CD
SIBT	NNT
PFJNIWT	JJ
PICWXIM	NN
BWLE	VB
MZWN	NN
MFMEWTN	NN
ELWLWT	VB
BWNDSLIGH	NNP
ATLJIQH	NN
QWFI	NN
PWRMLIWT	JJ
FLIXIM	NN
MAWWRIQS	NNP
SPWJNIQ	NNP
MWCB	VB
ESQIW	NN
IERER	VB
ESQIT	JJ
MPRIE	NN
NBIA	NN
HNDSIWT	JJ
DIQLM	VB
PNJZIH	NN
NENIM	NN
WWDAIT	JJ
AWPNH	NN
BRWMPILD	NNP
EWSQWT	VB
KLBIM	NN
BWLEWT	VB
NERMW	VB
RNWAR	NNP
AIWWAN	NNP
MEJWT	JJ
14132830	CD
MXWDFT	JJ
IWMM	NN
LJWBT	IN
NKSI	NNT
MZEZET	JJ
XJIBT	NNT
HTWWIIT	NNT
EMITW	NN
LWLA	IN
NERMH	VB
MEWLIM	JJ
MWSMKT	VB
ELWBIM	JJ
XIWBIT	JJ
JIEWN	NN
MAGAR	NNP
5203	CD
HTBGRWTW	NN
AWMLL	JJ
MXIIKT	VB
CIMCM	VB
MILIWN	CD
IRIDH	NN
WTQ	NN
MXD	RB
BIIM	VB
TZKWRT	NN
LXMM	VB
SBLW	VB
PEILWT	NN
LXMI	NN
PRWIQJ	NN
TXWMIM	NN
IQIIMW	VB
MMCA	NN
LHTPLX	VB
QNQN	NN
ZIKRWNW	NN
QWBEWT	VB
KWXW	NN
FWM	DT
FWN	NNP
AGTH	NNP
MRWFFT	JJ
FWD	NN
KSPWMJ	NN
BAFRI	NNP
FWB	RB
EITWNIM	NN
BLIT	IN
BLILH	NN
FWT	NN
IFTKNE	VB
FWQ	NN
FWR	NNP
LHTAWFF	VB
2391	CD
JIPWLIWT	JJ
HILWWAN	NNP
ALMGWR	NNP
MHNDSIM	NN
HKXDH	NN
MSWKN	JJ
PWJNCIALIIM	JJ
HTPFJH	VB
MWRIH	NNP
XDD	NNP
FPRINCQ	NNP
DIIQ	VB
IXNKW	VB
MIJH	NNP
MZLGWT	NN
DIZNGWP	NNP
LPRWK	VB
DIIN	NNP
DIIL	NNP
HRISH	NN
HFQPWTIW	NN
HTPFJW	VB
XWSK	NN
HTASP	VB
BWFWWIC	NNP
MWCGT	VB
MTWRBTT	JJ
RQE	NN
NGZRWT	JJ
DRWFIM	JJ
KTWMIM	JJ
SMK	NNT
RQM	VB
ITNHGW	VB
FARIWT	NN
CRIM	JJ
JDI	NNP
LKHN	VB
FWRR	VB
LHRHR	VB
MGLMT	VB
MMWQMT	VB
DET	NNT
CRPTIIM	JJ
PRNSISQW	NNP
NRDP	VB
QWLJIM	VB
HCMID	VB
QCINIM	NN
MWTIRH	VB
BQFTN	NN
LQLWJ	VB
IIKLLW	VB
857	CD
3,247	CD
AXRWNH	JJ
MKWWN	JJ
FM	RB
HBJXH	NN
PZWRH	NN
AWLJIMJWM	NN
MWZIAWNIM	NN
XLWCI	NNT
FPIWT	NN
MRWCT	NNT
GBAI	NNP
ADIPWS	NNP
HWLIWWD	NNP
DIILT	NN
CMWD	JJ
MWDRKIM	JJ
PNQS	NNP
XZQH	JJ
JRWPIT	JJ
NDIR	JJ
MWPT	NN
SMRJWJ	NN
NIJLW	VB
IZRMW	VB
KWFRM	NN
MGBLWTIW	NN
SIDWRI	JJ
MTRFMIM	VB
HSKMNW	VB
NICBWT	VB
MEFIRIM	VB
FWRF	NN
NIHLH	VB
SIRBH	VB
NEL	NN
NINWXH	JJ
HENWT	NN
HWSPNW	VB
PSIKWLWGIH	NN
DWXH	VB
27.40	CD
QRBWT	NN
ACL	IN
LHIXFP	VB
MTRPSIM	VB
LHKFIL	VB
FWTPIM	NN
9.90	CD
yyELPS	yyELPS
MHIR	JJ
MNSIM	VB
NER	NN
FKR	NN
SIRBW	VB
NIHLW	VB
PLPLIM	NN
MFQWLAIM	NN
AFMIM	JJ
HNIXH	VB
MBDRT	JJ
MJLWN	NNP
MSPRM	NN
HTBRRW	VB
BKI	NN
GDWLIM	JJ
NIQWI	NNT
MSPRT	VB
SJ.	NNP
TFWBH	NN
PRBR	NNP
NIQWD	NN
ZIWWH	NNP
GILM	NN
MSEM	NN
MNHIGIH	NN
GILH	VB
MSEH	NN
MDRFIM	NN
WWNSDII	NNP
RCINWT	NNT
TWPEWT	NN
MIFWR	NN
PATWS	NN
DAGLS	NNP
XILWPIM	NN
RWXNIT	JJ
MIIXLIM	VB
WWLS	NN
MSEW	NN
GILW	VB
MFQLW	NN
MWJWWSL	NNP
MED	VB
GDR	NN
HIFWWTH	VB
HWGFH	VB
IRWFLMIM	JJ
MEL	IN
RWAH	VB
RWAI	NNT
MBWJLT	JJ
NHGI	NNT
MEJ	DT
NHGW	VB
MFKWRTW	NN
NHGT	VB
MXZWRIM	NN
GDH	NN
GDI	NNP
HWGFW	VB
GDL	VB
LJWS	VB
LWX	NNT
MJRWTIW	NN
PRWGRMT	NNT
XWLCTM	NN
ANGLI	JJ
LWS	NNP
HIDRAWLIT	JJ
QRWWANIM	NN
NXWCH	VB
QSL	NNP
HCJBRW	VB
HWXZR	VB
ANGLS	NNP
LWI	NNP
RGLIIM	NN
ANGLW	JJ
ZLCR	NNP
ZMN	NN
EQILWB	NNP
APFRIT	JJ
IKIN	VB
BRWRIM	JJ
IWKLW	VB
FALWTIHM	NN
MLWWIM	NN
HCJRPWT	NN
CEDI	NNT
MCWIINIM	JJ
CEDT	NNT
ALJRNJIWWIIM	JJ
CEDW	NN
NSPX	NN
IKIR	VB
XLLI	NNT
EWMD	VB
EWMS	NN
EWMR	NN
EWMQ	NNT
MQRQEIM	NN
MIWN	NN
BRBRX	NNP
PWGFIM	VB
MQIIM	VB
NWHGI	NNT
ZAJWJIM	NN
IWNIWWRSL	NNP
NXFDH	VB
MTRXF	NN
QDM	MOD
DRWFH	VB
SMKWTH	NN
EZH	NNP
HCIEW	VB
GREINIM	NN
HSDR	NN
EZB	VB
NWHGT	VB
CPH	VB
CPI	NN
GNRLI	NNP
PEWJ	JJ
HERKTM	NN
MEWDDT	JJ
XQIRWT	NN
AWJWBWSIM	NN
LQSIQWN	NN
JWQIW	NNP
IDETI	VB
MRBI	JJ
MRBH	DT
CPT	NNP
SILQW	VB
CPW	VB
ALWHIT	JJ
XWLWNI	NN
MFWMF	JJ
FMRNIM	NN
PENWX	NN
LXIIM	NN
XMWRIM	JJ
LXIIG	VB
ALWHIM	NNP
MFLBT	VB
LXIIB	VB
MGWFMT	JJ
FWAPT	VB
TMIKT	NNT
BAIIRN	NNP
MIIXDT	VB
NRCXIM	NN
KIKR	NNT
LIWWH	VB
ARBE	CD
BJWXIM	VB
HTPTXH	VB
716	CD
XTWNH	NN
505	CD
MDBRIM	VB
NKBFH	VB
IPEL	VB
63.5	CD
HTPTXW	VB
EICWMN	NN
EICWMH	NN
IFRALIWT	JJ
IISD	VB
ANRIQW	NNP
EICWMW	NN
NBIAIM	NN
LHRIM	VB
NKBFW	VB
HGENW	VB
IWELH	VB
LSGWR	VB
EILH	NN
HARWWI	NNP
ZNIAL	NNP
NABQIM	VB
LHZMIN	VB
MTPLL	VB
QRQEWT	NN
RFIWN	NNT
IGBRW	VB
LCXWQ	VB
NMNIT	VB
QRSWLIHN	NN
MSTEPT	VB
EIWWRT	JJ
NKNSNW	VB
ANFI	NNT
LPEWL	VB
NIIJLIIN	NNP
1400	CD
HGNTH	NN
LHTQDM	VB
HISJWRIWN	NN
RMALLH	NNP
NMWKIM	JJ
FBUS	NN
RGFIIM	JJ
QRNIIM	NN
XWWIWTIH	NN
501	CD
ZKWIWTIHM	NN
HPSID	VB
AWMWT	NNT
AXWWT	NNT
TWTQP	VB
MFMEWTI	JJ
TWBA	VB
JRGDIH	NN
HDDIWT	JJ
TXWMIW	NN
GBWLIT	JJ
IWMW	NN
MBQRT	NNT
MXR	RB
WWLBS	NNP
FINIW	NN
LXKWT	VB
TQNWNI	JJ
PNSIWNR	NN
BRIJI	JJ
MBQRI	NNT
IWMI	JJ
SIBH	NN
MSTPQIM	VB
LEWRR	VB
MDIPIM	VB
LIPFIC	NNP
XWDRWT	VB
RAISH	NNP
HXLPTW	NN
MABQM	NN
ZIKIWN	NN
MQL	VB
ICANW	VB
AIRWE	NN
AFRW	NN
SIKLH	VB
XWZIM	NN
MATRWWL	NNP
TWLDWT	NNT
AFRT	NNT
TFPR	VB
MQS	NNP
HTLHBWT	NN
TSRIJ	NN
NWQB	JJ
WWLQN	NNP
BXWRIM	NN
MEBIR	VB
QIIJNWT	NN
NWQJ	VB
QWNWWNCIWNLIT	JJ
LRCWX	VB
XLQW	NN
XLQT	NNT
EMLWT	NN
ECMNW	PRP
AWWIR	NN
SWBLNWT	NN
RJNR	NNP
MDAIGIM	VB
FWHWT	VB
ZMR	NNT
XLQI	NNT
XLQH	NN
MIWXDIM	JJ
XLQN	NN
XLQM	NN
XSWMH	JJ
MIWXL	JJ
MXPIRH	JJ
TEFIITIT	JJ
MIWXD	JJ
IKWLIM	VB
ARMLI	NNP
TTXIL	VB
EWZBIM	VB
MIWXS	NNP
IXWIB	VB
HTBRRH	VB
MIMIQH	NN
ASPQT	NNT
HQCAH	NN
HNHGH	NN
TMIM	JJ
IWQRTW	NN
JRMPISJ	NN
GAWN	NNT
HTPRCWIWT	NN
TMID	RB
BJIXWTI	JJ
SRGIW	NNP
HWMNIJRIT	JJ
IWQRTI	JJ
MFTWLL	VB
HNHGT	NNT
AWBSSIH	NN
ASPQH	NN
NBDQH	VB
MNWTQ	VB
ZWRNL	NNP
BFMIM	NN
ZAWWIH	NNP
KMWT	NNT
HCHIRW	VB
NAMRH	VB
NAMRW	VB
HCHIRH	VB
IWBIL	VB
MXDLI	NNT
MEMQI	NNT
NBDQW	VB
NBDQT	VB
HLKT	NNT
LHBQIE	VB
QISINGR	NNP
HRGIF	VB
BZRNW	NNP
ARHB	NNP
RIGWBRJW	NNP
HWRFEW	VB
BRNADJ	NNP
Q	NNP
LHCIC	VB
LHCIB	VB
MRWXQ	JJ
TNWR	NNT
LHCIG	VB
MFQPIM	VB
LHCIL	VB
NKFLW	VB
3,825	CD
BWJLW	VB
HTAWFFH	VB
DIRDR	VB
EWNFI	NNT
RAFWNWT	NN
DXTH	VB
JWBT	NNT
TFWAWT	NN
BWJLH	VB
LSBK	VB
RCWNI	NN
QLIFAWT	NN
CWLMW	VB
LIIXS	VB
PRQLIJW	NN
PRQLIJT	NNT
EFIIT	NNT
ARJILRI	JJ
MKRW	VB
ALPIIM	CD
HWBQE	VB
SWTBIS	NNP
X	NN
PRQLIJI	NNT
PRQLIJH	NN
MKRZ	NN
LJQIH	NNP
HWDETW	NN
KMRIM	NN
XDFH	JJ
MTWART	VB
SRGII	NNP
HPRIIT	NNT
KWNNWT	NN
ITQE	VB
LHWKIX	VB
BXINTNW	NN
KDAIWT	NN
RCWNN	NN
RCWNM	NN
HMWLT	NNT
IRIBW	NN
RCWNW	NN
HMWLH	NN
NRDPIM	NN
MGBIR	VB
IXSMW	VB
MGBIT	NN
XSINWT	NN
HIRLAP	NNP
HIEDR	NNT
KTWM	NN
NQRAT	VB
PFWJWT	JJ
MWEJH	JJ
BIMAI	NN
TWLFWT	VB
RWIAL	NNP
IIRFMW	VB
BITURI	JJ
PRIMIJIBIT	JJ
IIPLA	VB
ALWZIWT	NN
MBCEIIM	JJ
QDIF	NN
MWTNH	VB
BQEH	NN
ASJRAJGIWT	JJ
FUX	NN
IARKW	VB
GFFIM	NN
HMLJ	NNP
AMRIQAIWT	JJ
MTPQDIM	VB
FWDD	NN
AINDWNZIH	NNP
TRDMTM	NN
HGW	VB
HBDLI	NNT
MWGDL	JJ
MICGIM	NN
IMINH	RB
BWRLI	NNP
MILNR	NNP
FBRIM	NN
SBILH	JJ
MTAMC	VB
EIFWN	NN
QWLQJIWWIWT	JJ
MIHM	QW
MIHR	VB
TPWRSM	VB
MFTNIM	JJ
FIGR	VB
MIHW	QW
SDRWT	NN
NWBLWT	NN
EIRAQIT	JJ
MBQFWT	VB
KPWPIM	VB
MDMMIM	JJ
IMINW	NN
KIBWFIHM	NN
EMWTT	NNT
ABQ	NN
KWRX	NN
GRBWZ	NNP
DMWTW	NN
FBITT	NNT
MINIAPWLIS	NNP
ZWGN	NN
MZKIRT	NNT
FBITH	NN
NMCAWT	VB
IKWLTH	NN
BWKWM	NNP
IKWLTM	NN
EMWTH	NN
LMPRE	RB
TMCIT	NNT
EWLMIM	NN
FTIIM	CD
MTNXLIM	NN
NRFM	VB
FPE	NN
FTIIH	NN
MFTTP	VB
NWCXH	VB
KLPI	IN
451	CD
ABW	NNP
PXWTIM	JJ
NAGTWLLH	NNP
HIDRDRWT	NN
JBE	NN
HIDALGW	NNP
XLWPWT	NN
IQFH	VB
HTLWNNH	VB
MWCLXIM	JJ
MCLMIM	NN
385	CD
CIJWJIM	NN
ICIRTW	NN
BWGRWT	JJ
NWCRI	JJ
NJWF	VB
AXDWT	JJ
CIBWRI	JJ
AJRQJIWWIT	JJ
HCBIEW	VB
DGM	NN
EZIBT	NNT
JWRNH	NNP
MRADWNH	NNP
AIILWT	NNP
DMI	NNT
NWCRW	VB
FILWJ	NN
ICIRTM	NN
BRANDJ	NNP
HERH	NN
1,800	CD
ARCIWT	JJ
JEMW	NN
LIDTN	NN
HERB	RB
TPNH	VB
EDFWT	NNT
JENWT	NN
EWSQT	VB
TNHL	VB
ALWWARW	NNP
MKTBIM	NN
HWGBLW	VB
JEMH	NN
NWBEWT	VB
XWBWT	NN
HIPWKWNDR	NN
AMNWTI	JJ
LHJBIE	VB
MPQPQ	VB
QRBN	NN
NWGEWT	VB
HWFMJ	VB
QRBJ	NNP
QRBH	VB
MZHH	VB
EWMDIM	VB
SIMWLCIH	NN
HWFMW	VB
MKRIM	NN
MRWKZT	JJ
ITR	NN
CILWMIM	NN
ITRWNW	NN
HKREWT	NN
MTEWRRWT	VB
ERKW	VB
QFWT	JJ
ZMIN	JJ
LCAT	VB
MFWTP	JJ
QFWR	VB
HTRXQWT	NN
LMCER	RB
GILWI	NN
FMFWT	NN
EWNFW	NN
IGIE	VB
QWMNDW	NN
BELWT	NNT
ITRWNM	NN
ERKM	NN
SWRRIM	JJ
XWZRIM	JJ
BIN	IN
BIL	NNP
IQFW	VB
MIIXS	VB
BIH	RB
NMSRT	VB
MPLST	VB
QRIAWT	NN
BIB	NNT
HWLDTW	NN
APIDMIWLWGIH	NN
CIMQ	VB
JIIS	NN
NWBLH	NN
FWLLT	VB
IFAIR	VB
HTAWFFW	VB
BIT	NNT
BIR	NNP
MWCDQ	JJ
ASTJI	JJ
BI.	NNP
MDEIT	JJ
ACJJ	NN
MSGD	NN
TPQID	NN
ANJIFMI	JJ
TIQW	NN
MISWI	NN
SLE	NNT
CWEDT	VB
SGNWNW	NN
07	CD
HIPK	NN
RXWBWTIH	NN
AIFIWTW	NN
MCE	NN
MCD	IN
MCB	NN
MCA	VB
PAXM	NNP
AIFIWTM	NN
AIFIWTK	NN
MTXRH	NN
XIILIM	NN
GFM	NN
AINKM	RB
MENW	NN
NAWTIM	JJ
MTBJA	VB
LHMXIF	VB
LQX	NN
PRWJQCIH	NN
MBCEIT	JJ
HTMWDDWT	NN
ITQIIM	VB
LQH	VB
MBCEIM	VB
HTGWRRW	VB
AQDMI	JJ
ABIGDWR	NNP
NCXI	JJ
BWDD	JJ
TIIRWT	NN
HFLIM	VB
MDINIWTH	NN
HIRBTH	VB
FLIJTM	NN
HMWNIT	JJ
HWKXT	NNT
BWDQ	VB
NCXIT	JJ
HWKXH	NN
MDINIWTW	NN
LHRJIJ	VB
AZWRIWT	JJ
DISNILND	NNP
MNKUL	NNT
ALJRNJIWWH	NN
BEQBWT	IN
FWJPIM	JJ
HDRGH	NN
BJWXH	JJ
RWMUH	NNP
NFLXW	VB
LKTWB	VB
MIUL	NN
LHCLIX	VB
IWGFW	VB
HCIGH	VB
BIQWRTI	JJ
MGID	NNP
KDWRIW	NN
LHTPEL	VB
QJN	JJ
ICLMW	VB
TWSIP	VB
AIZWFHI	DT
TEFIH	NN
QJE	NN
LEITIM	MOD
GIDI	NNP
EMWSIM	JJ
KIM	NN
KDWRID	NN
MECRM	NN
LSPWG	VB
QDWFH	JJ
KDWRIM	NN
HCIGW	VB
KSPIT	JJ
XRM	NN
HBRPLD	NNP
LSMWK	VB
CRW	VB
MBJAH	NN
ABJUA	NNP
HZDQQWT	NN
NQBEH	VB
KSPIM	NN
CRH	JJ
PEILWIWT	NN
BAQRAI	RB
PS	NNP
THWDH	NN
MTXMQT	VB
RBEIM	NN
TINWQT	NN
PT	NNP
HFTRE	VB
MRJIN	NNP
HTRWCCWT	NN
QPCW	VB
NMLJH	VB
FBITTM	NN
NMLJW	VB
NMLJT	VB
PG	VB
IWBRR	VB
PNQSK	NN
PH	RB
MWECWT	NN
HIQPIM	NN
MNIX	VB
MICGI	NNT
HFTRR	VB
FKWNTI	NN
FQDIM	NN
HERKWT	NN
MWFBWT	NN
FBE	CD
MMLKTI	JJ
LHEMIDH	NNP
MSWRTIIM	JJ
QFWXIM	JJ
FBJ	NNT
TLWIH	VB
XRB	NN
P.	NNP
AWWRWR	NN
NBDQ	VB
NKXW	VB
FBH	VB
MRWAIINIM	NN
ITWMI	NNT
RMTM	NN
FWRCQWP	NNP
SPRW	NN
DIIQNWTW	NN
MWPQDIM	NN
NQWDH	NN
BWQEWT	VB
NQWDT	NNT
QICWNIWT	JJ
SPRH	NN
HTENIINWT	NN
NBDL	VB
129.90	CD
BEBWR	IN
QRQEIT	JJ
AWCR	NN
TWBE	NN
NWLD	VB
AWJWQRJ	NN
PGIFH	NN
IGWWEW	VB
575	CD
MFMRWT	NN
GWMHWR	NNP
TTAKSN	VB
HWBLT	NNT
AMITIWT	JJ
MWGZM	JJ
PGIFT	NNT
601	CD
MRFMIM	NN
XMIM	JJ
HSTLQWT	NN
600	CD
AWLRIK	NNP
HLWIIT	NNT
8.3	CD
8.5	CD
HXMIR	VB
KMWSIM	JJ
RAFIIM	JJ
NJL	VB
AWXZ	VB
NMNET	JJ
BMQBIL	IN
MQFR	VB
KWWNWT	NN
ARIZWNH	NNP
AISWP	NNT
DRMJI	JJ
GIBWRI	NNT
FAPTNWT	NN
SIMNIM	NN
NAJUW	NNP
HXLIMW	VB
PIBRWQ	NNT
TFLWMI	NNT
GIBWRW	NN
SRJN	NN
AWRH	NNP
MWRGFT	VB
MXIH	NN
MXWZWT	NN
KXWLH	JJ
SIDR	VB
HPGNTIWT	NN
PAWLW	NNP
MRDIMIM	JJ
SMWIH	JJ
PIGR	VB
HGMFT	NNT
LEWLM	RB
PWNW	VB
MRWFEWT	JJ
CMITWT	NN
BZBZNIT	JJ
MKRET	JJ
MFTPIM	VB
PRIDMN	NNP
ELIH	NN
MTNFA	VB
SIKNW	VB
ELIT	NN
PSWL	JJ
ECWBIM	JJ
MSI	NNT
TQCIBIT	JJ
NPTXH	VB
SWKNWTW	NN
PGANIWT	NN
GIAWLWG	JJ
BNIGWD	IN
KWWIITIIM	JJ
RGEIM	NN
RWKFIM	VB
LHTDIIN	VB
MQWISJ	NNP
MWKFRIM	JJ
RGEIT	JJ
TWPST	VB
NPTXT	VB
NDWDI	NNT
QWMTW	NN
MXIIB	VB
FXWRIM	NN
ALIAB	NNP
MWSDWT	NN
XMWRH	JJ
ZKH	VB
FBIEWT	NNT
KRIZMJIT	JJ
QWDMW	NN
HLKNW	VB
QWDMT	JJ
WWIINFJIIN	NNP
INWE	VB
HDPIS	VB
ESQIIM	JJ
ZKW	VB
XMWRW	NN
ZKR	NN
NWX	JJ
NQMT	NNT
NGDIT	JJ
QWMQWMIM	NN
SBWRH	VB
IJLW	VB
XIPFW	VB
KBWL	VB
NHIGH	NN
MCDH	NNP
MRAWT	NN
HTERBWTW	NN
NQMH	NN
CIBWRIWT	JJ
KBWD	NN
HFMJT	VB
DLQWT	NN
LMFL	RB
GWZP	NNP
HPCT	NNT
QWBL	NNP
XWZR	VB
PICWL	NN
PNQIIBIC	NNP
QWBH	NNP
TWMRIN	NNP
PRIXTM	NN
QWBE	VB
FIXQW	VB
MTECM	JJ
AFRAI	NN
BINLAWMI	JJ
MAZINIM	NN
MRDNIWT	JJ
FIXQH	VB
LHWRID	VB
SPINT	NNT
XWZI	NNT
XWZH	NN
HDWQ	JJ
HDWR	JJ
LAHWB	VB
FPILD	NNP
MWGDRIM	VB
HTLQXWT	NN
IPRWC	VB
BCL	NN
HKRET	NNT
LHIBXR	VB
MNHJN	NNP
MWXLJ	JJ
MBCEIWT	JJ
LBRWX	VB
HBISH	VB
HNHLH	NN
HGBLWT	NN
FIJWT	NN
JNQIM	NN
TNUK	NNP
TGWBWT	NN
GRWEIM	JJ
LIGH	NN
ERBIWT	JJ
TNUC	NN
LIGT	NNT
LHXIWT	VB
FNTW	NN
MWSIP	VB
XAN	NNP
TRGWLWT	NN
AHBW	VB
TPEWLH	NN
FWQRWN	NNP
HBLIH	NN
HBLIJ	VB
NACIM	NN
LXWLL	VB
25,000	CD
SNSACIH	NN
HBLIE	VB
LSLQ	VB
MRFIMH	JJ
BLEDIT	RB
NHWGH	VB
540,000	CD
BRHUM	NNP
DXISWT	NN
AIWN	NNP
IIKNSW	VB
MTKWWNWT	VB
NACIT	JJ
SNAJWRIM	NN
GNIM	NN
MQMILN	NNP
HLLW	JJ
AIFH	NN
AIFI	JJ
NISWIIM	NN
HWBSW	VB
IRIBWTIH	NN
LIRJH	NN
TCLIX	VB
LHMFIK	VB
DWBR	NNT
HERTI	VB
AIFR	VB
FIRH	NN
BHTXFB	IN
TXWFH	NN
HKNSTM	NN
ERKAWT	NN
HFEIH	NN
SKWUM	NN
HKNSTW	NN
TXWFT	NNT
AINDIWWIDWALIWT	NN
MWFPLWT	JJ
AMWRWT	VB
MLIC	NNT
GIJAWT	NN
BSISW	NN
SWNIH	NNP
RIBWNWT	NN
LABD	VB
MHNHIGWT	NN
IAXL	VB
ZQWQ	VB
FXWQIM	JJ
MISJI	JJ
MRKZIT	JJ
MISJR	NN
CPWNIWT	JJ
MFQWP	NN
HTPRCWT	NN
MQWRIT	JJ
MTENIIN	VB
BERK	MOD
BSISI	NNT
KWKBM	NN
HTAPFRH	VB
MMWMNT	VB
TWKNNW	VB
DWDW	NNP
HMWNI	NNT
KWKBA	NNP
KWTBT	VB
DWDI	NNT
BRWJW	NN
TWKNNH	VB
GREWN	NN
ETWIIN	NN
AXWTW	NN
DPNH	NN
GALJASRAI	NNP
ISKIMW	VB
LERWB	VB
3,000	CD
IRDW	VB
HFTTQW	VB
LCWRK	IN
IFRH	JJ
BLEA	NNP
IRDN	NNP
LAXWZ	VB
HGBIRH	VB
CLIL	NN
ELTH	VB
FUS	NNP
PWNDMNJLISJ	NN
HFTLBWT	NN
HQJNT	NNT
MSMKIM	NN
HZMNT	NNT
FWBH	JJT
TPIFH	NN
FWBL	NNP
TPIFT	NNT
GWBANI	NNP
9.1	CD
RFMIWT	JJ
MINH	VB
MINI	MOD
HFRATH	NN
MXLWQT	NN
MJPXT	NNT
BBRKW	NNP
IIWWCR	VB
AWNIWT	NN
MWFBH	NN
MAWPIINT	VB
MZINH	VB
MWFBW	NN
FIIX	NNP
MKSIQW	NNP
GWWN	NN
MELIMIM	VB
RAWI	VB
NBEJH	VB
RXBEM	NNP
MNWXT	NNT
EWZRIM	NN
LHIPK	RB
MPLCWT	NN
DXW	VB
MTKWT	NN
ABIBIWT	NN
MILANW	NNP
BEIITIIM	JJ
FMC	NN
MRKZIH	NN
EWZRIW	NN
QBWEH	JJ
CID	NN
MDRIDI	JJ
QFWRIM	VB
INKW	VB
CIR	NN
LZRWE	VB
BINTIIM	RB
LKDI	IN
ASAM	NNP
MICTH	VB
MCLMWT	NN
DAG	VB
ITWMH	JJ
RAFNW	NN
DAL	NNP
MDWIQIM	JJ
SWGI	NNT
HIMNEWT	NN
BMAI	NN
SWGM	NN
MGLIM	VB
SWGR	NNT
NICXWNW	NN
HPGNH	NN
FWLXN	NN
BWDPFJ	NNP
FI	NNP
HWTR	RB
DAZ	MOD
HMIJH	VB
MACW	NN
LIZR	NNP
HFTDLW	VB
HTXTNH	VB
RWPAH	NN
FNIT	RB
XLXWL	NNP
CWPRIM	NN
XGIGH	NN
XGIGI	JJ
MAWXRIM	JJ
NWBLGIN	NNP
MQBLT	VB
NDMH	VB
LHTBSS	VB
FNIH	JJ
XFIPT	NNT
FNIM	NN
AIMPRIWT	NN
PEMI	JJ
99.90	CD
4391	CD
QWNWWNCIWNLIIM	JJ
HBJXWTIW	NN
HWDLP	VB
ALEZR	NNP
LPNWT	VB
HZMIN	VB
NJILT	NNT
XIPH	NNP
TWRPH	NN
IJH	VB
NIDRF	VB
MFDRIM	NN
MMHRIM	VB
EREWRIM	NN
JKNWLWGI	JJ
SLZAR	NNP
AGB	RB
HILT	NNT
ERIM	NN
SIRNI	NNP
SIRNH	NN
CRKN	NN
MSWPR	VB
XJIBWT	NN
AGP	NNT
BWQ	NNP
BWR	NNT
LDQWR	VB
XWMWT	NN
FEMWM	NN
HILH	NN
RIJH	NNP
GWNSWN	NNP
MEGL	NN
RGLIT	RB
RGLIW	NN
BWA	NNT
BWC	NNP
KLKLI	JJ
KLKLH	NN
EWLMNW	NN
LBNWT	VB
ATIWPIH	NNP
QWRBNWT	NN
XBWRT	NNT
BWN	NNP
MTMFK	JJ
MHWLH	JJ
EINIW	NN
FAWLI	NNP
HTQIIMW	VB
FWDR	VB
ASTJIIM	JJ
HIMWR	NN
HEMID	VB
LWL	NN
LWNDWNI	JJ
SIJWACIH	NN
PWJRWT	VB
TPIFWT	NN
CWBRT	VB
AWJWBIWGRPI	JJ
MAT	IN
MAZ	IN
SNJ	NN
NEFTH	VB
MWBXRWT	JJ
MWEDPT	JJ
MBZH	VB
MAD	MOD
RIBAWND	NNP
HIQPN	NN
MAI	NNP
MAH	CD
NMHRWT	JJ
ITWGBRW	VB
MAM	NNP
HWGBL	VB
RWEH	NNT
MCWWH	VB
LHZNIX	VB
NTNIITIM	NN
JWN	NN
ALBWMIM	NN
ALNBI	NNP
DWWWX	VB
LPNIHM	IN
HIQPI	NNT
HTLHB	VB
PJRWKIMIH	NN
AIMWNIT	NN
ANDRSWN	NNP
NMASH	VB
HIQPW	NN
BWJL	NNP
TQWWT	NNT
LHTGRF	VB
BWJH	JJ
BICI	NNT
LSJ	NNP
HCEWTIW	NN
LST	NN
PRIDLNDR	NNP
XRWFT	NN
TQWWH	NN
LWQRSIH	NNP
XWWITI	VB
JBEIIM	JJ
NDIRWT	JJ
HPR	VB
BICE	VB
PRICWT	NN
LHMIR	VB
PARIS	NNP
MFTKRIM	VB
BWBWTIH	NN
DQIQ	JJ
MRDNI	JJ
LTLWT	VB
ZKIIH	NN
IBDWQ	VB
MWEGLIM	JJ
MTLWNNIM	VB
SWZI	NNP
NMLJ	VB
IEQB	NNP
HWQCH	VB
MINIMLIWT	JJ
PANIQH	NN
NMFKWT	VB
MWFPEIM	VB
PIST	NNT
LZRWQ	VB
IJWS	VB
RIPWI	NN
QHL	NN
MEMDIT	JJ
LIBWBIC	NNP
AWSQR	NNP
BIDWD	NN
CWER	NN
HPXT	NNT
ARMSJRWNG	NNP
HTMNH	VB
BIDWR	NN
HEBRTM	NN
EKFIW	RB
JJRIT	JJ
NTWWKX	VB
GWRLH	NN
MWTQPIM	VB
QRAWS	NNP
RPWRMH	NN
RPWRMI	JJ
IEQBI	NNP
MWDEWT	NN
LQWXWTIW	NN
XWJPIM	NN
IFXRR	VB
HMCIAH	VB
PWRJW	NNP
HMCIAW	VB
TQPWTN	NN
MAFIM	VB
HFTPR	VB
HTNHGWT	NN
MWQM	VB
AIMWN	NN
IIDQR	VB
ZRIQT	NNT
JRPIM	JJ
AIMWC	NNT
MGBILH	VB
PNJSIH	NN
AIRIM	NN
IWZMNW	VB
NWSXAWT	NN
MWQI	NNP
XBILH	NN
CIPWI	NN
IWDPSW	VB
JMPRJWRH	NN
MRGIEIM	JJ
JJRIM	NN
1991	CD
1990	CD
1430	CD
MERICIW	NN
SIRQIN	NNP
CIWNI	JJ
33.90	CD
IPELW	VB
QICWNIIM	JJ
ECWMIM	JJ
EWFRW	NN
XKMI	NNT
MERICIM	NN
ICGW	VB
HWCA	VB
2.81	CD
IGRWM	VB
IKWLTW	NN
MWQP	VB
IAMCW	VB
550	CD
RIIK	NNP
HRCAH	NN
PWEL	NN
8.35	CD
LHIMNE	VB
ATGRIM	NN
ALKSNDRWNI	NNP
IGRWR	VB
FIQWLIW	NN
DMWI	JJT
TXMWFT	NN
ARSIT	JJ
MXWFBIM	VB
MQDF	NN
LHTELM	VB
MNDJ	NN
HTBQFH	VB
AWZN	NNP
AWZL	VB
QWNWWQJWRIM	NN
FIQWLIM	NN
DMWTH	NN
MZERI	JJ
KRIFIM	NN
DMWTK	NN
GLWSQA	NNP
BEIH	NN
DBWRH	NNP
RPWAI	JJ
MABQIH	NN
MABQIM	NN
XIIBIM	VB
XUKIM	NN
NISINW	VB
AWPJIMI	JJ
MWPQR	JJ
IIPWL	VB
NPWC	VB
KWAB	VB
HBEWT	NNT
SBWN	NN
ADWNI	NN
MQWLQLIM	VB
MJR	NN
GIBRIL	NNP
AGMI	NNP
BITURIWT	NNP
EIIRT	NNT
QSJRW	NNP
JWRQIT	JJ
DIKWI	NNT
DPWSIM	NN
AWQRAINH	NNP
LHFPIE	VB
HIITH	VB
GDWF	JJT
HTKWWNH	VB
PIINL	NNP
MFPXTI	JJ
BLUL	NNP
QRISTN	NN
7691	CD
IBBT	NNT
HBNIIH	NN
MMHR	VB
HFTQPWIWTIW	NN
TTXZH	VB
SCINWT	NN
ZIT	NNP
MILQI	NNP
MFPJIWT	JJ
WINICIW	NNP
MJRTM	NN
AITWT	NN
HRFIM	VB
MJRTH	NN
MIQRQSIM	NNP
HTIR	VB
MJRTW	NN
INWDH	VB
XBLTW	NN
KRMLH	NNP
MRBITM	NN
LRDT	VB
KTMI	NNT
MDLIQ	VB
MRIRWT	NN
PTIXH	NN
DBIQ	JJ
LHEMID	VB
SMKWTIWT	NN
LMDW	VB
LMDI	MOD
LMDH	VB
PTIXT	NNT
MBWGRT	JJ
JARPLI	NNP
MDLIH	NN
TQIEH	NN
NGBH	NNP
FWWRC	NNP
MINWIIM	NN
IEILWT	NNT
MSEWTIW	NN
LHQPID	VB
IQWM	NN
DWBRIM	NN
NPC	NN
LSNR	NNP
NGBW	VB
HPEM	RB
AMNWT	NN
QHILH	NN
JRIIM	JJ
NICBT	VB
DANDI	NNP
NFALIM	NN
MNHLT	NNT
HKRX	NN
GLIMWT	NN
MFMF	VB
MNHLH	NN
MNHLI	NNT
NCIGWIWT	NNT
FIXWT	NN
NICBH	VB
AMNWN	NNP
QHILT	NNT
AWBIIQJIWWI	JJ
LHTRPQ	VB
MZHMIM	VB
TNSH	VB
TIPWL	VB
XFBTI	VB
BLEDIWT	JJ
LRAFWNH	RB
MFTMFIM	VB
GRSTW	NN
NAXZ	VB
FWNIM	JJ
TSKWLW	NN
DGF	NN
LIMWD	NN
NTMKH	VB
GWAJMALH	NNP
MTBQFIM	VB
LHIJWTM	NN
PJWRH	VB
ENP	NNT
HTNGD	VB
XCI	NN
NWRMN	NNP
XCR	NN
LMTWX	VB
SRSWR	NNT
MWSQWBIC	NNP
ZHBH	NNP
SGWRWT	JJ
LHIPQX	VB
ITGLW	VB
EWCMH	NN
HTQIIMH	VB
MLBSQI	NNP
BRIKWT	NN
MTKWWN	VB
EWCMT	NNT
NQREW	VB
MGWWNT	VB
TRGILIM	NN
LIBRLI	JJ
JEMIM	NN
HTXIIBWT	NN
MIGWN	NN
MWCIAIM	NN
TWQJN	VB
CIPIWT	NN
HCBIEH	VB
KWNSH	VB
HTNXLW	VB
AMWNIM	NN
ATPJR	VB
HTMWJJWT	NN
WWLGRIWT	NN
TPLWT	NN
DWLRIT	JJ
MXPFWT	VB
MQWRWT	NN
B	IN
IXSIT	RB
IXSIW	NN
FBEIM	CD
MFWXRRT	JJ
JIPWSI	JJ
FPXH	NN
HRWG	NN
DWLRIM	NN
IXSIM	NN
NCIGIM	NN
TUQ	CD
MKWNIWT	NN
MQFRT	VB
TQNWN	NN
EQRWNIT	JJ
MWBIL	NN
TQNWT	NN
19.9	CD
TUA	NNP
LHTGLGL	VB
AGRWT	NNT
QWPUX	NN
SPWLDING	NNP
LQXT	VB
IWQCW	VB
ZWHMH	NN
MENIQH	VB
PWLISWT	NNT
RDIW	NN
MGWRIM	NN
DWRJMWND	NNP
EINIH	NN
MGWRIW	NN
SPRDIM	NN
LQXH	VB
HCLH	NN
NAMNWTW	NN
Q.	NNP
LAMR	VB
CLMIM	NN
NLEG	JJ
MXIIBWT	JJ
ALWNI	NNP
SMWK	RB
CMR	NN
EQWMH	NN
LNAWM	VB
LAWJNBRG	NNP
PNWI	JJ
DWXIM	VB
PWTX	VB
RIKWZI	JJ
MENIQWT	VB
APFRIWT	NN
ABSWLWJIT	JJ
TXRWTI	JJ
GLWMWT	VB
400,000	CD
MWNET	VB
ETWDWTIHN	NN
MBWQFT	JJ
LBFW	VB
NERKW	VB
TFIFWT	NN
NERKT	VB
WRDI	NNP
SKIN	NN
AXRIWTW	NN
LWBI	NN
WWLGARI	JJ
NWRMWT	NN
AMRWTIHM	NN
TQIN	JJ
PIGWARDW	NNP
GWMLIN	NN
QR	JJ
QT	NNT
QW	NN
MMDIW	NN
QLWFIM	JJ
BRWNZH	NN
RPAUL	NNP
QSM	NN
AIXWDH	NN
XILWNIM	NN
QC	NN
QF	NN
IWEMDW	VB
QM	VB
QL	JJ
TQIP	JJ
TNWRI	NNT
FLFWL	NN
PAS	NNP
GLWLH	NN
MHWWH	AUX
PIINSWD	NNP
MWQDMIM	VB
CRPTIWT	NN
HTRXFWTM	NN
HTAXDWT	NN
PAB	NN
HFTDL	VB
7.6	CD
DQIRH	NN
PRIDH	NN
TNWEWTIHM	NN
QWBLIM	VB
MPWJRIM	NN
HTQFRWTW	NN
PWRQH	VB
FIGRW	VB
SNJR	NN
PWRQN	NN
FIGWR	NNT
XZIR	NN
XZIT	NN
LFBF	VB
MWSRI	JJ
FPIKWT	NNT
FLWMIT	NNP
MSNNT	NN
HFKIRH	VB
SWER	JJ
LFBT	VB
FIGRH	VB
0203	CD
SIJWNI	JJ
ITN	VB
TTBCE	VB
MDINIWT	NN
HFIMW	VB
SGNW	NN
MTMRMRIM	VB
IIXFB	VB
CIJWJ	NN
LPWCC	VB
IZREAL	NNP
STIRH	NN
ISPWG	VB
CEIRIM	NN
SNDINISJIM	NN
TWMNW	NN
FLWFH	CD
MQWMWNIM	NN
RBWT	JJ
FLWFT	CDT
SNDINISJIT	JJ
ERMWN	NNP
AWRWGWWAI	NNP
HDDIT	JJ
IHA	VB
QWALICIWNIIM	JJ
MWRFEI	NNT
PLIAH	NN
MSIIRT	VB
LHQIM	VB
KWTRTH	NN
GBI	NNT
GBW	NN
GBT	NNP
RIKWZIWT	JJ
GBR	NN
HGINWTW	NN
MERBI	JJ
SLMINH	NNP
DIKAWN	NN
MERBB	VB
LZRWM	VB
BZBWZ	NN
RIDN	NNP
MFWPE	JJ
ITWM	JJ
HSTIIM	VB
EICWB	NN
AMWNTW	NN
CEIPIM	NN
TEMID	VB
AWBDN	NNT
ERKH	VB
QRBT	NNT
DRG	NN
HDRGTIIM	JJ
BJXWNH	NN
LHCMID	VB
NPRDW	VB
XFDNWT	NN
PTLTLIM	JJ
NKPPW	VB
ALKSNDRS	NNP
RGILH	JJ
HRMJIT	MOD
HTNGDWTH	NN
MHWWIM	VB
LHCMIT	VB
AMWCIWNLIT	JJ
ICIEIM	NN
FFIT	JJ
NPRDH	VB
NHAR	NNP
SJIWT	NN
WWHBH	NNP
NSIETW	NN
SWRDI	NNP
TINWQWT	NN
HMWN	NN
FRIRIWT	JJ
JQSJ	NN
GZZT	NN
JQSI	NNT
AZRN	NNP
HITH	AUX
RWKF	VB
MAKZBWT	JJ
LQWWT	VB
MWLDTW	NN
RWKB	VB
HTXZQW	VB
MECMWT	NNT
TWKXT	NNT
IIFMW	VB
HTQFH	VB
XSINWTW	NN
LMNWT	VB
BHKRX	RB
KMH	DT
KMW	IN
RMDAN	NN
XFWBH	JJ
MZWIPT	JJ
KDWREP	NN
LMNWE	VB
SIKWN	NN
ETH	RB
HTQFR	VB
SIKWI	NN
IILMAZ	NNP
PWRJWGL	NNP
BWHW	NN
LZRWS	NNP
BWHQ	JJ
EMIR	NNP
HIQNW	VB
ITGWRRW	VB
QIIMA	NN
IPRGNW	VB
BWHZ	NNP
GILWP	NN
PJIRTW	NN
LWNDWN	NNP
QIIMT	JJ
QIIMW	VB
TFIM	VB
MSLQIM	VB
MWTAM	JJ
XWSLW	VB
AKZBWT	NN
MWBILIM	VB
MTNPL	VB
EWRRW	VB
AWXZIM	VB
XFBWNWTIW	NN
NSXP	VB
RIIKMN	NNP
ANDWQRINWLWGIH	NN
MJMIEH	VB
MEIDH	VB
EWRRH	VB
QWLNI	JJ
NMNW	VB
QNW	VB
HWQMH	VB
QNS	NN
MSRBT	VB
HTQIIM	VB
NQRA	VB
BITUR	NNP
ANXWT	NN
WIQJWRI	NNP
PFWJH	JJ
HTQIIR	VB
EWCR	NN
MTXILH	VB
HWQMW	VB
NQRW	VB
MRQMIM	NN
QNH	NN
NMNH	VB
QNJ	NNP
IGIF	VB
BGUC	NNP
FLWWT	NNT
HWZRQ	VB
XRIPH	JJ
FRWN	NNP
MWPQT	VB
MNJLIWT	NN
FRWT	NNT
XIWWR	JJ
GIA	NNP
IFRWR	VB
PIJWRIN	NN
WNCWALH	NNP
AWLMI	NNT
QJIGWRIWT	NN
HQRNWT	NN
MFLXT	NN
NXTMW	VB
IEBDW	VB
DRMH	NN
HKPLT	NNT
QHILTIIM	JJ
MWDN	NNP
MSWKNWT	JJ
ZWLLI	JJT
1151	CD
ZKITI	VB
PWRNWGRAPIIM	JJ
MLEIJIM	VB
LIIBWR	NNP
HFTQPWT	NN
QDWFIM	NN
FMRH	VB
ZETR	NN
WWALAS	NNP
MBIK	JJ
LNWX	VB
ECMW	PRP
1975	CD
MGMTW	NN
KISW	NN
HBIEH	VB
ECMN	PRP
ECMM	PRP
ECMK	PRP
ECMI	PRP
ECMH	PRP
HWPIE	VB
XFWDIM	NN
FMRW	VB
AWPIINIWT	JJ
IWKI	NNP
HWMWRISJIM	JJ
IWKL	VB
FIIQH	NNP
FIRWTIW	NN
SWKNWIWT	NNT
BKLL	MOD
MSPRIM	NN
QAWL	NNP
CWMCMW	VB
REIFWT	NN
TWPRWT	NN
JIIM	NNP
TWFB	NNT
PTWXWT	JJ
MMLKTIWT	JJ
PINNSIT	JJ
LHIMLJ	VB
FRFRAWT	NN
SGIDH	NN
HLQAH	NN
NALCH	VB
RWCX	VB
MBIEH	VB
LHTEJP	VB
AWTW	DT
LHINQJ	VB
HJRID	VB
HWCAWT	NN
MIWXLT	JJ
AWTN	DT
BLAQMN	NNP
AWTH	DT
MINIMWM	NN
HIDRWGNCIH	NN
NALCW	VB
PCWEH	VB
PIRSM	VB
PALAS	NNP
ALMNTW	NN
NIBA	VB
WWRIACIH	NN
IRXMIAL	NNP
yyEXCL	yyEXCL
LFBWT	VB
AIJLQIT	JJ
QLAWS	NNP
HTIIXSWT	NN
NTPST	VB
HWMRI	JJ
PWGEIM	VB
MAPIWT	NN
MINIWTN	NN
SWCIALIWT	JJ
HFGXH	NN
LHTNCL	VB
IIEWL	NN
1977	CD
NISIWNW	NN
WMWNJH	NNP
IIEWC	NN
HTXFBWT	NN
LXPF	VB
536	CD
QIDWM	NN
531	CD
HWMWRISJIIM	JJ
QIDWF	NNT
TLWNWT	NN
JILPNTI	VB
QLSIQH	NN
LAXRWNH	RB
FWXRI	NNT
FLBIM	NN
PAIZ	NNP
EKW	NNP
SNIQRS	NNP
QLWRIWT	NN
PITRWNWT	NN
NRCXW	VB
MABWJ	NNP
NGIXH	NN
ZRIM	NN
MKRIE	JJ
IHWDIM	NN
IHWDIH	JJ
FRIWN	NN
LFNWT	VB
MTNGD	VB
LHFTNWT	VB
LHTGIIS	VB
MXNWT	NNT
RWXMH	NNP
IHWDIT	JJ
MKRIX	VB
NWTQP	VB
MKRIZ	VB
HTKH	NN
SWGIM	NN
MILWI	NN
QWNPDRJIWWIIM	JJ
HKIR	VB
HTQFRWT	NN
MILWA	NNP
MHWLLT	JJ
PDRL	NN
FQAR	NNP
601,016	CD
NSGRT	VB
CXI	NNP
HPGNWT	NN
FQAF	NNP
SKRT	NN
MRXIQT	JJT
HIDRWTRPIIM	JJ
QIBWCIT	JJ
PLAJWT	NN
IWGDRW	VB
QWNDS	NN
AWHBIM	VB
BTIM	NN
WQPKWT	ZVL
MISWD	NNT
HFQPT	NNT
MFIMT	NNT
NXLQT	VB
MXRID	JJ
MWTIRIM	VB
MFIMH	NN
MSTWRIN	NN
HDSH	NNP
MWFXTT	JJ
NWJINGHAM	NNP
HFQPH	NN
XZRH	NN
JRIWQ	NNP
ELIITM	NN
TBIA	VB
21.9	CD
HTRAIIN	VB
XWQRI	NNT
XWQRT	VB
GWRDWN	NNP
HQPID	VB
IIBNH	VB
ELIITW	NN
HQPIC	VB
XZRW	VB
MWSMK	NNT
DIDAQJI	JJ
LICN	NN
KDAI	VB
BRWM	NN
TIKWN	JJ
BRWN	NN
ICIRT	NNT
BRWK	NNP
HEDRWT	NN
TINWQ	NN
MTQBLT	VB
BRWR	JJ
NGZRW	VB
AIBRHIM	NNP
LHJIL	VB
PWRJ	NNP
HTNER	VB
MFWGE	NN
LWMDIM	VB
QIRBTM	NN
HIEDRM	NN
SPWRWT	JJ
NFPJW	VB
MSWGLT	VB
MXWZQWT	VB
MDD	NN
BNIHM	NN
NIPCW	VB
HWDWT	IN
PWREIM	NN
XSIMH	NN
MNWGDWT	JJ
JRIBIWN	NNP
IHWDIWT	JJ
FINNTI	VB
TWK	IN
LPXD	VB
IIXWDIIM	JJ
TWM	NNT
TWR	NN
MPIQ	NN
AIBD	VB
PSILT	NNT
PNJSIWT	NN
AIBH	NN
NABQT	VB
NABQW	VB
KWLLNI	JJ
AINDIANH	NNP
MNHG	NN
TABD	VB
HNIE	VB
AMWNH	NN
MFWRRIM	NN
DWBRWBICQI	NNP
RWGZ	NN
GIFTM	NN
ERWKWT	VB
EIWNIWT	JJ
AGRWP	NN
XDLH	VB
RDIPT	NNT
CBIETW	NN
TXPWFT	NNT
HNIX	VB
1,005	CD
MXSWR	NN
RWWXH	NN
XFAIT	JJ
AXRIM	JJ
XBRIH	NN
MTGWRR	VB
ENIIN	NN
XBRIM	NN
MAWREWT	NN
AXRIT	NNT
CHWBIM	JJ
MNWRT	NNT
XBRIW	NN
HWGDR	VB
MRKIBI	NNT
EKBRI	NNT
MSXR	NN
FBXIM	NN
RXMIM	NNP
RWWXT	JJ
GIWS	NNT
MXSWM	NN
ZIGWG	NN
SPCIPIT	RB
CWRBT	JJ
WWRN	NNP
JJRIIM	JJ
HRUI	NNP
SINNW	VB
JKNWLWGIWT	NN
SJJISJIQH	NN
JWAJAW	VB
RAWIIM	VB
QWPWT	NNT
MWRWT	NN
BRWNW	NNP
ABNIM	NN
FJRIT	NNP
RIBLIN	NNP
TWFME	VB
TNAIHN	NN
35.5	CD
QMIM	VB
LQ.P.R.	NNP
QDWF	NNP
TRWPH	NN
HTIIECWIWT	NN
MTWGBR	VB
IDWEH	JJ
MWZNIM	VB
TWQPIM	NN
ZWEQIM	VB
HMFK	NN
MQLJI	NNT
FARLWJ	NNP
NLKD	VB
LKH	NN
yyLRB	yyLRB
LEBR	IN
MGEIM	NN
BIJRN	NNP
RFTWT	NN
KINRT	NN
PRWIND	NNP
DGL	NN
IFNWT	JJ
HIWM	RB
DWWQA	MOD
FALTI	VB
LGBWT	VB
LGBWR	VB
FIMF	VB
MAPFRIM	VB
DQRW	VB
MENQIM	NN
LAWRK	IN
MKRIZIM	VB
LAWRH	NNP
AMNIM	NN
LBDH	MOD
LBDW	RB
TNWPH	NN
MFBR	NN
MDWWXIM	VB
SR	NN
ETIQH	JJ
TQWM	VB
TQWH	NN
ARWJI	JJ
HTXIIB	VB
JBEIT	JJ
MRFIMIM	JJ
LHTNQF	VB
MRWT	NN
EFWIH	VB
SWGIHM	NN
MTNHLWT	VB
MRWN	NNP
MTBRRT	VB
TWRTW	NN
EMIDWT	NN
CMX	VB
CMW	NNP
MKINIM	VB
AIDIAWLWG	NN
PCE	VB
BMEJ	RB
LQRAT	IN
KHNISJI	JJ
MSMNIM	VB
HFGT	NNT
PRIFH	NN
FLWM	NN
HWPC	VB
PIQDWN	NN
MXWKMIM	JJ
HWPK	VB
PQDH	VB
PWRSM	VB
SJWQJWN	NNP
CWRWT	NN
XILWPI	NNT
MQFWT	VB
RCINW	VB
MAGR	NNT
PNIW	NN
FKXTI	VB
NQJET	VB
PNIM	NN
JWENWT	VB
MTED	VB
MWKIX	VB
PNIK	NN
MWEMD	NN
SIJWNAI	NNT
QIPWX	NN
6,000	CD
GBWLWTIH	NN
GRWSMN	NNP
DLPQ	NN
MLQWLM	NNP
GBIE	NNT
DRIKWT	NN
FINWWH	NNP
HWPTE	VB
JILPN	VB
MAWFR	JJ
HKNWT	NN
ERERW	VB
MZRXI	NNP
TCPIT	NN
GLI	NNT
FPAIIR	NNP
CRIKH	VB
GLM	NN
MEWGLIM	JJ
RIALISJIT	JJ
9.13	CD
9.11	CD
AKN	RB
FMIIM	NN
DIWWIZIWT	NNT
KWLNW	PRP
FWPRSL	NNP
QLPIM	NN
LHQDIM	VB
MFDRT	VB
PJMH	NNP
HWPSQW	VB
QLPIF	NNP
JIWX	NN
EILWM	NNT
MWRIDH	VB
SMWKH	JJ
SDIRH	JJ
GZIRH	NN
MECR	NN
HFTATH	VB
MFWRR	NN
JIWL	NN
LHSTIIM	VB
MBQRIW	NN
QCINI	NNT
MXSNIM	NN
HCIPWIIIM	ZVL
F	REL
NWPXH	VB
SWCIALISJI	JJ
MKWBDT	JJ
HNXIITW	NN
SBSWD	NN
TNCX	VB
IHSSW	VB
MBQRIM	NN
MWLIK	VB
IIPGFW	VB
MWLIN	NNP
MGDT	NNT
MXLH	NN
RMZWRIM	NN
MMFLTNW	NN
AQSPWZICIH	NN
PEILI	NNT
PEILH	JJ
FMWRH	NN
ARBEIM	CD
BMHLK	IN
CWPH	VB
NISIWN	NN
SBB	NNT
SNIPH	NN
MMN	IN
LHIXFB	VB
XFAIIM	JJ
MMD	NN
SNDRLND	NNP
MMF	RB
MZKUL	NNT
SBL	VB
XSIN	JJ
MQWCR	JJ
XWZRT	VB
PTWRH	JJ
XSID	NNT
MPQDIH	NN
AJLNJH	NNP
WAJNFIID	NNP
ERF	NNT
HMRIA	VB
ERB	NN
WLDIMIR	NNP
MQCWE	NN
ERI	NNT
ERK	NN
WWLDRIDG	NNP
MFMXT	VB
MILWIH	NN
EIQWLIM	NN
MRIDWT	NN
LHTPWRR	VB
PLIJIM	NN
CWIN	VB
MWAC	JJ
BRIIJMN	NNP
KAWBH	JJ
BWNH	NN
KRISJINH	NNP
HTGWNNWT	NN
MWZKRIM	VB
RWMANIM	NN
GARDN	NNP
PRJI	JJ
BEIIT	NNT
AJWMI	JJ
LWQACR	NNP
LHTLBF	VB
NWQFWTW	NN
IICWR	NN
BEIIH	NN
TIAJRLIT	JJ
5.4	CD
NMHR	JJ
PIWS	NN
PARMH	NNP
PWRNIR	NN
QRIWT	NNP
KWWNWTIW	NN
NWPLIM	VB
QLP	NNT
QLN	NNP
SQRI	NNT
QLJ	VB
BRWQLIN	NNP
QLH	JJ
RMWT	NN
QLE	VB
MTPLLIM	NN
HITRIM	NN
LFWKRH	RB
FWWIG	NNP
HMLCH	NN
FWWIC	NNP
MITWLWGIH	NN
NIQWLH	NNP
HXMICW	VB
FWWIM	JJ
BXIRH	NN
FWWIH	NN
BXIRT	NNT
CPIRWT	NN
BRWRWT	JJ
MKTBW	NN
HMLCT	NNT
HGIX	VB
MCIPH	VB
AILMIM	NN
HWQCBW	VB
RQ	MOD
RS	NNP
BDRNINW	NN
QASBH	NN
MEWPPWT	NNT
3791	CD
RZ	NNP
HFTTP	VB
RE	JJ
HTRBW	VB
2151	CD
RB	JJ
RC	NNP
HRISWTIHM	NN
HGIB	VB
ABWD	JJ
HGIE	VB
HGIF	VB
PELH	VB
APFRI	JJ
ZKWRH	VB
ZHIRH	JJ
EMDH	NN
LMDNW	VB
HBNH	NN
NMRCWT	JJ
PNIMIIH	NN
HBNT	NNT
MQRWB	RB
EMDW	VB
EMDT	NNT
QJL	NN
R.	NNP
PNSIIT	NNT
SINTJIT	JJ
HFTKRWTM	NN
FMLT	NNT
LTAR	VB
HTLHBW	VB
IDIT	NN
DQIRT	NNT
MDRGH	NN
IDIH	NN
KICD	QW
BJLH	VB
22.5	CD
025055	CD
LTAM	VB
IDID	NN
MTPFR	JJ
SIMS	NNP
SIJI	NNP
IWUR	NNT
HWBJX	VB
TXQIR	NN
JBLT	NNT
AMITIIM	JJ
HZNH	NN
TWHH	JJ
MTPFJ	JJ
MCXIQH	JJ
HTPFRWT	NN
HERKT	NNT
MWFEIM	JJ
MINWIW	NN
WWDI	NNP
MBIKH	JJ
JBIEWT	NNT
HIMWRIM	NN
MFLXWT	NNT
XMCN	NN
ALMWNIWTW	NN
CRKNIWT	NN
HGBRT	NNT
MTRXFIM	VB
MRWCIM	JJ
HETQH	NN
QNITI	VB
SHRH	NNP
IEZWR	VB
DWPI	NN
MKNIZM	NN
HETQT	NNT
QWNBQJWRIM	NN
MTWXH	JJ
MTBHR	VB
NPSQ	VB
XIIQWL	NNP
MXRTIIM	RB
MPIQIM	VB
HTNHGWTW	NN
JLPWNI	JJ
WALIWM	NNP
519	CD
HTNHGWTM	NN
HQHIL	VB
LRBWT	IN
TWTIR	VB
511	CD
IIZKR	VB
BIQWRTW	NN
516	CD
MCBN	NN
RDPW	VB
DIIRI	NNT
MCBM	NN
ILDIM	NN
RWGBI	NNP
ZWLWT	JJ
FWLPIM	VB
SNIGWR	NN
EMID	JJ
DRGWT	NNT
BDRIAN	NNP
PILGRIMM	NNP
MILJWN	NNP
MCBW	NN
ILCIN	NNP
LHFTXRR	VB
DPWS	NN
LWAI	NNP
HTNSWT	NN
NICXNW	VB
DLIL	JJ
HNGBI	NNP
MMCAI	NNT
GRIM	VB
TMIMWT	NN
MEWGL	JJ
FWPJI	NNT
MXZIQIM	VB
HWRAWT	NNT
FWXZRW	VB
MQLEIM	NN
FIPC	VB
PCEIW	NN
HESQT	NNT
DAWS	NNP
MXWIBWTW	NN
MRKIBIW	NN
TWLET	NNT
IIWWTR	VB
RISRC	NNP
JPR	NNP
NBXRWT	NN
SPRIIH	NN
QAWPMN	NNP
FIPR	VB
MSXRI	JJ
MTLHMIM	JJ
PCEIH	NN
MJRPT	JJ
TPQWDH	NN
AWRLNDW	NNP
XNINH	NN
TPQWDI	JJ
GDEWNIM	NN
JWWH	VB
ZEH	NN
AIRWNIH	NN
MNDLMN	NNP
HPQIDW	VB
ZEM	NN
MFXQIM	NN
MRAIM	VB
ENIINIM	NN
LHWSIP	VB
FWWIWN	NNT
BWDDIM	NN
MCLIXIN	VB
JWWX	NN
HWLIWWDIWT	JJ
EMLWTIHN	NN
HTLWWH	VB
BFETW	RB
DQWR	NNP
MHLKM	NN
CRIK	VB
MWMLC	VB
ETIQIM	JJ
FLIXWT	NN
IDIDIH	NN
MFIKH	NN
MWJXT	VB
FIPA	NNP
36.4	CD
LSJR	NNP
PFRH	NN
NLQXWT	VB
PGIFWT	NN
GWRRT	VB
BXN	VB
XWPF	NN
0408	CD
XWPI	NNT
MCWMCMT	JJ
ASIRIM	NN
MNBAIM	VB
MAZNW	NN
APIPIWR	NN
HWFALW	VB
HWCG	VB
TXWM	NNT
MWFQEWT	VB
MTNGDWT	VB
EJWPH	VB
NDWNH	VB
RANGWN	NNP
BFWRH	NN
TWFG	VB
MAPFR	VB
LIAZ	NNP
RGLW	NN
HARKH	NN
RGLI	NNT
MFKWRTM	NN
CMDN	NN
MTXT	IN
BRQW	NNP
NELIM	NN
HSPDW	NN
EJWPT	JJT
ELWLH	VB
AWWT	NNT
LIAH	NNP
XWTKT	VB
MFENT	NN
NINW	NNP
NFIPH	NN
XGG	NNP
NMCAIM	VB
LHWJH	VB
QRWNWT	NN
MKFIRI	NNT
PRW	NNP
NWRIC	NNP
HAMBWRG	NNP
ERBWT	NN
MGALWMANIT	JJ
TXFWB	VB
HTNCL	VB
XRWJIM	JJ
LPZR	VB
KRJISI	NNT
TQL	VB
TQN	NN
MLAKTW	NN
LFGFG	VB
MEBIDW	NN
IEFH	VB
FRJWJ	NN
NXFBIM	VB
KRJISW	NN
AXIH	NN
APFRWIWT	NN
ZNXW	VB
AWNRWWUA	NNP
FITWQH	NN
HCLXH	NN
QBIEWT	NN
KDWRI	NNT
MNCLIM	VB
MENIQIM	VB
MBFRT	VB
IXLIP	VB
LAWMNIT	JJ
MZWIN	JJ
HDWQIM	JJ
HWFMEW	VB
FWWRCMN	NNP
NFKBW	VB
AXIDIM	JJ
MIC	NN
MEWNIINIM	VB
ITQFR	VB
SWKNWT	NNT
ABJXH	NN
IARX	VB
MWZRIM	JJ
MJBE	NNT
ZIMAN	NNP
NHNIT	VB
MJBX	NN
ITQFH	VB
NPFWT	NN
MLXMWT	NN
PRWPSWR	NN
GRSTH	NN
FEN	NN
MIKST	NNT
PI	NNT
ZQWQIM	VB
PN	NN
MSPIQIM	JJ
HWFPEH	VB
LIBRIWM	NNP
MQWDFIM	JJ
SWBSIDIWT	NN
MIIXSIM	VB
SWBLWT	VB
RGFWTIW	NN
MXWIIBIM	JJ
ERBWB	NNT
TTIR	VB
QJNIWT	NN
BWRMZI	JJ
EMD	VB
MIWTRIM	JJ
MRGLIM	NN
MINSWJIIM	JJ
EML	NNP
EMI	NN
PIQWDI	JJ
DRWFWT	JJ
MXWSPST	JJ
EMW	NN
EMQ	NNT
RGE	NN
RGF	NN
EMR	NNP
MIQDMH	NN
MWXFIIM	JJ
RGL	NN
MRGLIT	NNP
QIZZH	VB
RCINIIM	JJ
NWFL	VB
HZIWTIW	NN
TEFIIH	NN
IMNH	VB
IMNI	JJ
KIRWRGIT	JJ
ARIG	NNT
EITWNWT	NN
BWQR	NN
3	CD
AMICH	JJ
HLIKTK	NN
XWBWTIH	NN
STIW	NN
TEFIIT	NNT
LIMWDIM	NN
FWPCW	VB
MWRXT	VB
MGZINIM	NN
ELIWN	JJ
ELIWT	NN
GZIZWLIN	NNP
HWDXH	VB
PSNTRN	NN
NABQWT	VB
BMQWM	IN
MFWLMT	JJ
AMRNW	VB
TQINH	NN
MLPNI	IN
LAWTT	VB
MFEWL	NN
IPHPIIH	JJ
XWR	NN
QWD	NN
MQBLIM	VB
LBJA	VB
RIALIIM	JJ
PIJR	NNP
MWAFMIM	VB
MTRGM	NNT
QWR	NN
QWQ	NNP
TQUM	NNP
ILD	NN
KWRDIT	JJ
MFLH	VB
CWRT	NNT
CWRP	VB
ILK	VB
PER	NN
PEL	VB
PEM	RB
AJRQCIH	NN
MLAIM	JJ
CWRH	NN
PRNSTW	NN
CWRK	NN
7791	CD
IHIRWTH	NN
MTIXWT	NN
BJIXWTIIM	JJ
THPWKWT	NN
MZHIRIM	VB
MSTIIM	VB
KAXD	MOD
HTNTQW	VB
TKTWB	VB
BRKWT	NN
HWRW	VB
MSTIIG	VB
HWRH	VB
LFNN	VB
TERIP	NN
AWFIWT	NNP
SIMPAJIM	JJ
MCBIE	VB
KFLW	VB
MIAQWBSQI	NNP
HWRG	NN
PWNDMLISJIIM	JJ
ZIMN	VB
ZIMH	NN
LCIID	VB
NISIWNWT	NN
MMFIKIM	VB
LHPIL	VB
MWDIEIN	NN
MWDIEIM	VB
MXWZI	JJ
JRGI	JJ
SM	NNP
QCB	NN
QLEIM	NN
QRJR	NNP
MHNDS	NN
ARWNW	NN
MFMETIT	JJ
TELH	VB
AWZNINW	NN
MFIBIM	VB
ANJIFMIWT	NN
LIN	NNP
KWLLT	VB
LHDIX	VB
QNAIM	JJ
AFLIH	NN
MKH	VB
GNB	NN
MJPXWT	NNT
AIN	VB
MKS	NN
NKLLIM	VB
AIK	QW
SLQCIH	NN
AIG	NNP
AIF	NN
WINGIIJ	NNP
MKLLWT	NN
IIEWDIIM	JJ
HMFKIM	NN
NSPW	VB
ALTWR	NN
FMIKH	NN
MXFID	NN
GLWBWS	NN
AWLIMPIH	NNP
FWTPWT	NN
BRQIN	NNP
CIWNWT	NN
AWLIMPIT	JJ
IPGE	VB
MNSH	VB
BWXRI	NNT
MFWLM	NNP
MFWLL	JJT
IWRKBW	VB
XWM	NN
ZDWNI	JJ
ZLWJIQMN	NNP
HTXIIBTI	VB
LIBRLIZCIH	NN
HMWNIM	NN
APLWLIT	NN
IIMCA	VB
EBRIT	NN
MXNH	NNT
MXNK	VB
KWBF	VB
NISN	NNP
MTIMJIWT	JJ
AWDISIAH	NNP
PNGAB	NNP
ASJWN	NNP
LFKWT	NN
NPLA	JJ
AWLPNI	NNT
SDR	NN
HTQPIM	NN
RMTW	NN
NKPTH	VB
IDIETW	NN
LFKWX	VB
BHFWWAH	IN
NKXH	VB
SNSCIH	NN
NPGFIM	VB
NPLW	VB
MKWPLT	JJ
CEQNIWT	JJ
AWIRH	NN
HTQPIT	JJ
NRAWT	VB
LHGDIL	VB
AWPIIM	NN
IDWEIM	JJ
AWRWT	NN
GBETIIM	NNP
APLWT	JJ
MSIRH	NN
NWCXNW	VB
IABQW	VB
MSMRWT	NN
HTQBC	VB
MKFLH	NN
PARQ	NN
LSIIM	VB
RPWAIT	JJ
BRISJWL	NNP
PALC	NNP
HTQBL	VB
RIGWFIM	NN
IFMRW	VB
IRNDRH	NNP
MINISJRIWN	NN
BWLS	NNP
MWCP	VB
MWBFWBIC	NNP
AIBWD	NN
BWLJ	JJ
BWLM	VB
MWDRNIZCIH	NN
MWCE	VB
MFDRWT	VB
MWCG	VB
MWCA	NN
HEBIR	VB
IARMQWB	NNP
WLDZ	NNP
TKRIE	VB
XSRIM	VB
GASQWIN	NNP
JRIWWIALIWT	NN
MPGIF	VB
FWJRIM	NN
XLFH	JJ
TXRWT	NN
MFDR	VB
LALW	NNP
MSIRWT	NN
PWRMLI	JJ
MPAUI	NNP
EDIP	VB
NICWCWT	NN
EDIM	NN
EDIN	MOD
PDIWN	NN
TDWN	VB
LMSD	VB
MBIAH	VB
QJLNIT	JJ
NKWNH	JJ
QIWSQ	NN
TWQPM	NN
SJWDNJ	NN
MCWINIM	JJ
DIRWG	NN
JRIIKMN	NNP
AWRIAH	NN
PIRWFW	NN
LCMCM	VB
ECIM	NN
DIRWT	NN
HKIN	VB
NSIWNWT	NNT
MZGNI	NNT
PIRWFH	NN
CWLET	VB
MWRICIT	JJ
LNSX	VB
PIRWFM	NN
PITWX	NN
SMKWIWT	NN
PITWI	NN
NXFLWT	NN
IWWNIT	NN
TWEBR	VB
AIRWX	NN
MWERKT	VB
ZKWTW	NN
MNFR	NN
HCLIXH	VB
MDEI	JJ
TDHMH	NN
NACI	JJ
NCPH	VB
MDEN	NN
NACR	NNP
RIQWD	NN
XWWIWTIW	NN
XLKAIM	NN
WWLBW	NNP
HCLIXW	VB
ZKWTH	NN
ZKWTM	NN
MDRIK	NNT
MJWSIM	NN
IEMWD	VB
HWFLK	VB
KDWRIHM	NN
8.51	CD
GNRL	NN
SPWNJNIWT	NN
IFIBH	NN
MSWIMIM	JJ
LEWDD	VB
NXTH	VB
RWZLSR	NNP
GLIFH	NN
NXTM	VB
IWWN	NNP
DWQR	NN
IBQR	VB
IFIBT	NNT
HERIM	VB
HERIK	VB
MMFLH	NN
AWJWNWMIIM	JJ
112.90	CD
NWJRLH	VB
HPLILW	VB
TWJL	VB
NWJWT	VB
NFMWR	VB
MBIIM	VB
TGBWRT	NN
MMFLT	NNT
HGBLH	NN
QCIN	NN
QRAT	VB
ZIQTH	NN
NIFA	VB
BRAFWNH	RB
AMWCIWNLI	JJ
ITXIL	VB
SWCIALISJ	NN
MGWWNWT	JJ
BGDWL	RB
AIFIIM	JJ
LIKWD	NN
QWHL	NNP
AIDH	NNP
FITPW	VB
GWNZALS	NNP
HFBTH	NN
HTPRSMW	VB
MWQSIN	NNP
MTXWLLIM	VB
HWJBEH	VB
QLINIT	JJ
MBJIXH	VB
IRIWT	NN
MPTXIM	VB
LHTNGD	VB
PTAWM	RB
TLBWFWT	NN
HTPRSMH	VB
NFBW	VB
CDIM	VB
BIQFW	VB
PWELT	VB
PWELW	NN
MGIBWT	VB
PAWLI	NNP
PAWLH	NNP
WIRFWBSQI	NNP
BXIRWT	NN
MMILA	RB
LRNR	NNP
NFBE	VB
XDRH	NNP
PWELI	NNT
HALH	NNP
BIQFH	VB
MCLIX	VB
XDRW	NN
TWQPW	NN
AISWR	NN
LHPEIL	VB
IARXW	VB
GIBWRH	NN
MWPLAWT	JJ
ALBLDS	NNP
LHGN	VB
FIRI	NNT
XIBWRI	NNT
ZINWQI	NNT
MQNH	VB
AWPI	NN
AWPN	NN
WSJRIS	NNP
AWPQ	NNP
MEDW	VB
NNXL	VB
FIRT	VB
XIBWRW	NN
DNIS	NNP
LHGR	VB
WWRLD	NNP
MGNIM	VB
MFWKLLT	JJ
BIJXWNW	NN
HWPIEW	VB
BIJXWNM	NN
DRWZIM	NN
HWPIEH	VB
BIJXWNI	JJ
NPWCH	JJ
FISTH	VB
HPWKH	JJ
ALIMLK	NNP
ZMNNW	NN
ARCWT	NNT
MSGRTW	NN
JWRINW	NNP
AIRWNI	JJ
JWS	NNP
LHTAZR	VB
LPIKK	RB
IDXH	VB
JWL	NNP
GIJRH	NN
XBWRH	NN
PDRCIH	NN
MSGRTH	NN
JWB	JJ
EITWIH	NN
JWF	NN
DRBI	NNP
MWCDQT	JJ
RWPIN	NNP
HWFIEW	VB
MECRW	NN
MIWBAT	JJ
ARWBH	NN
IIDXH	VB
XWRG	JJ
LHTMWDD	VB
KITH	NN
AIWDIH	NNP
HWCIAW	VB
XWRP	NN
XTWMWT	JJ
EIIRH	NN
FITWPH	NN
HWPQ	VB
IFMFW	VB
LWWIINIM	NN
HPXDT	NNT
FMEWNWB	NNP
TPISTN	NN
NWGE	VB
SJNDRDIIM	JJ
QBRWTIHM	NN
IPHPIH	JJ
BHQDM	RB
1,875	CD
NSBLIM	JJ
FRIDIM	NN
LAWMIT	JJ
HTNCLWT	NN
LHTRPA	VB
ARWGNJIT	JJ
XWFFIM	VB
MKRIHM	NN
IMNEW	VB
MCWQTH	NN
HAWWRD	NNP
PWJBWL	NN
RAFWNIM	JJ
SNIGWRIM	NN
LAWMIM	NN
MDWRG	VB
HKRNW	VB
ICIRWTIW	NN
DWLR	NN
LPTX	VB
IWSJWN	NNP
LBLBL	VB
CPCPH	NN
LPTE	RB
IBWLW	NN
HGNWT	NN
XJIBH	NN
ZMNIT	JJ
ITGFM	VB
FMFTH	NN
TANH	NN
QWALICIH	NN
PGRH	NN
HUH	NN
DIBRTI	VB
NRGFWT	JJ
TEFIINIM	NN
MINSWJH	NNP
TPEWL	NN
MGDIR	VB
LEG	NN
ITNW	VB
SPRTI	JJ
NPFIT	JJ
SNDINISJI	JJ
ERKTI	VB
MDGIF	VB
XLWPH	NN
XLWPI	JJ
LAZN	VB
FFIM	CD
MZWWDWT	NN
HTPREWT	NN
NIHILISJI	JJ
IFRALIT	JJ
NPGFTI	VB
LHTHWWT	VB
MSBIR	VB
HDGIF	VB
BRWRH	JJ
GBINWT	NN
IFRALIM	NN
HXLIQ	VB
TQNIM	NN
TQCIBIM	NN
LHIRAWT	VB
EBIRH	NN
EWBDTIT	JJ
NERIM	NN
MPWRFWT	RB
NTNW	VB
NTNH	VB
REH	NN
S.	NNP
A.S.	NNP
MWDRNIIM	JJ
REB	NN
EBIRT	NNT
REF	NN
FCP	NN
LQRB	VB
MFWKNE	VB
RCINIWT	JJ
FIMFW	VB
PWRT	NNP
LFBWR	VB
LFM	IN
ESQW	VB
EZIM	JJ
FWMRT	VB
LWWAI	NN
IMLA	VB
FWMRI	NNT
FWFNH	NNP
BHRBH	MOD
PWRE	VB
IIXWDI	JJ
HRSNI	JJ
IFXQ	VB
MFTLM	VB
ESQT	NNT
DWRFWT	VB
AIRIT	JJ
ALWHI	NNT
MFQIPIM	NN
LHNIA	VB
LHNIB	VB
EWRKI	NNT
AIJLIH	NNP
HFTTPWTM	NN
MWFJT	VB
XWLFWT	NNT
RWDIAW	NNP
AWPRH	NN
DMIWN	NN
HFTTPWTW	NN
IQNW	VB
JILIM	NN
LHNIX	VB
HWPET	NNT
ECWBH	JJ
EWRKW	NN
EWRKT	NNT
PIHM	NN
NIIDWT	NNT
XISLW	VB
RCINI	JJ
814	CD
IITLWW	VB
SP	NNT
ERPAT	NNP
SK	NNT
SJ	NNP
SI	NNP
XZWIH	JJ
BIUX	NN
SN	NNP
QUG	NN
SL	NN
KSPW	NN
XISLH	VB
QUM	NN
SE	NNP
SD	NN
PJRIARKLIT	JJ
ZIMWN	NN
CWPR	NN
FWMEIM	VB
HIBJIM	NN
IBF	JJ
GWDLK	NN
25.11	CD
SNQCIWT	NN
SPWNH	JJ
CWPN	VB
GWDLN	NN
LIJAIM	NN
MRXIQIM	VB
MTWXKM	JJ
5357	CD
ALRGI	JJ
PGE	VB
RIALI	JJ
ZINWQ	NN
ASIH	NNP
INCX	VB
MRSI	NNP
PELW	VB
NBXRT	NN
MLAKH	NN
MLAKT	NNT
JBXWT	NN
MRSR	NNP
NEFWT	VB
PGR	NNP
CWRKI	NNT
XLWCIM	NN
LFLM	VB
LFLB	VB
XCIH	NN
FIX	NN
PWAMH	NN
EBWTH	JJ
MCXIQN	NN
NWXIM	JJ
MNIETH	NN
FPIGL	NNP
42.02	CD
MARGRJ	NNP
TWCAH	NN
XSKWNWT	NN
HWLKWT	VB
EWFIM	VB
MBJ	NN
IQNH	VB
MCLIXIM	VB
QJIN	NN
FWPK	VB
HTNSH	VB
MSTMK	VB
FWPJ	NN
AWMRWT	VB
MSTMA	NN
MWRW	NN
RWMN	NN
RWML	NNP
MIM	NN
MIL	NN
MWNXT	VB
MIN	NN
EIDN	NNP
XWDWRWB	NNP
RCIM	VB
AWWIRT	NNT
MID	RB
RWMA	NNP
AWWIRH	NN
FIJ	NN
GDLIM	NN
RCIP	NN
BHMFK	IN
RWMW	NN
988891	CD
IXLIJ	VB
XDIF	JJ
PWLNI	JJ
NMFKW	VB
PRAIT	JJ
LCIIT	VB
NMFKT	VB
LXSWK	VB
SIRWT	NNT
QILLW	VB
HTGMD	VB
ZKWIWT	NNT
MPTXWT	NNT
MLMDT	VB
MNQH	VB
ADWMIM	NNP
PRNSTM	NN
AQHWIZ	NNP
NQJ	VB
NQI	JJ
LCIIN	VB
JJRINPWRM	NNP
NQM	NN
MEWGNT	VB
JWRDT	VB
HFEIIT	NNT
FINIIM	NN
HTGLMWTH	NN
PXTW	VB
HTIIXSNW	VB
INWEW	VB
FMWNT	CDT
IBWAN	NN
LHTNXM	VB
MFQWLWT	NN
HFNH	RB
ELMIN	NN
SNJIANH	NNP
TWBET	NN
AKIPT	NNT
NPJR	VB
QIIM	JJ
FMWNH	CD
SWLR	NN
XGBI	NNP
MMIJ	VB
SIWRW	NN
KSP	NN
PAPA	NN
FXIQT	NNT
ZKWKIT	NN
RWWXTM	NN
HWDEWT	NN
QRIST	NNT
BAMT	RB
MESIQIM	NN
EIIRWT	NNT
HTBQF	VB
ICIAWT	NN
NWFM	JJ
GWIIM	NN
FXIQH	NN
FLILIIM	JJ
HWZHRW	VB
PTXH	VB
MWEJ	JJ
7	CD
NPJRH	VB
HZDHITI	VB
KWABIM	JJ
LMDNIM	NN
MWED	NN
XTWM	JJ
XTWL	NN
HZRMH	NN
MHGRWT	NN
RWWXIM	NN
CIWD	NN
BITN	NN
AISLAMIWT	JJ
HNHGTW	NN
QSMIM	NN
JISH	NN
CIWN	NNP
XFIBWT	NN
BDIXH	NN
GWRDN	NNP
CIWW	VB
BIHMUF	NN
XLWPIIM	JJ
HTKWNNW	VB
NZHRIM	VB
MWJIWWACIH	NN
MCIINT	VB
FGIAWT	NN
HIRANW	NNP
HQRIN	VB
MLMDIM	VB
IEIL	JJ
MSGDI	NNT
MZKIRIM	VB
IEID	VB
KWLLIM	VB
2371	CD
HCBTW	NN
LNQH	NNP
LHBDIL	VB
FKMW	NN
PSIKIT	JJ
MLAH	JJ
MLAI	NN
MLXMTIWT	JJ
MXRT	NN
MLAW	VB
LIJWL	VB
BSISIHM	NN
XINWK	NN
MLKWTI	JJ
LWEGIM	VB
HTRFM	VB
PLDMN	NNP
TXNH	NN
FALW	VB
ITIIXS	VB
TXNT	NNT
MJBXI	NNT
PNIWTIHN	NN
MLKWTW	NN
NFIAWT	NN
TSPR	VB
TSPQ	VB
HTIIXS	VB
MXZH	NN
IFQWL	VB
HWENQW	VB
HWKFR	VB
ISPQ	VB
RXL	NNP
WWITWR	NN
MXPFT	VB
AIGWD	NN
5102	CD
HTNGDWT	NN
ARNS	NNP
MRWFLT	JJ
MDRKH	NN
496	CD
RIAQCIH	NN
HXLIFW	VB
MTMFKT	JJ
MDEWT	NN
PRSPQJIWWH	NN
SPRWTIT	JJ
IEWD	NN
LEQR	VB
KWKBIHN	NN
IWCGTI	VB
TRWMTI	NN
FKRM	NN
MFRTT	NN
TRWMTM	NN
TRWMTN	NN
IWQR	NN
GLIDH	NN
MDINTW	NN
AQCIH	NN
RAWIH	VB
IBWA	NN
AIGWR	NNP
FAJI	NNP
WWRWNIN	NNP
IWQM	VB
SINI	NNP
FKRW	NN
SING	NNP
IBWL	NN
PTWXIM	JJ
TRWMTW	NN
RWJFILD	NNP
BIALIQ	NNP
LHIMFK	VB
MFRDIH	NN
MPEILH	VB
JWPIQ	NNP
HRCAWT	NN
MFRDIM	NN
ECMAWTH	NN
BRISL	NNP
ECMAWTN	NN
PILSWDSQI	NNP
MGNWM	NNP
ECMAWTM	NN
BK	NNP
TPWQT	NNT
MCJRPIM	VB
HGEH	NN
ZWGWT	NN
HEBRH	NN
LMFK	IN
WIKWX	NN
LMRWT	IN
HEBRT	NNT
IFBITW	VB
MAIDK	RB
85.2	CD
NZHR	VB
IAMR	VB
PIGRW	VB
RKZIM	NN
XZRTI	VB
FDRWT	NNT
LHTXRWT	VB
LHTNER	VB
MNHIGI	NNT
MTKWWNT	VB
IPJRL	VB
HPRJH	NN
ICJRKW	VB
MCWID	JJ
MTKWWNIM	VB
HSKMIM	NN
XWLMWT	VB
IWNPQW	VB
NISWI	NN
NFLX	VB
FWXXW	VB
HTABD	VB
PICWI	NN
HDBQH	NN
MHLKW	NN
MTMWDD	VB
NFLL	VB
AWMFLAGPLAC	NN
CPWIWT	VB
NGDI	JJ
BELIM	NN
BIIQR	NNP
IWFR	NN
HWBQEW	VB
PTXNW	VB
NNQJW	VB
AIDIAWLWGIH	NN
RNJGN	NN
CPWNIT	RB
IRWN	NNP
5107	CD
IRWQ	JJ
XNGH	NN
SBIBTN	NN
BDWMH	IN
HTXIH	NNP
MPTH	JJ
LAWMIWT	JJ
HTXIL	VB
AWRN	NN
MSTMNT	VB
AWRM	NN
AWRK	NNT
MIICBT	VB
AWRI	NNP
ANJI	MOD
MQLE	NN
NPALI	NN
HTKWWNTI	VB
LHDLIP	VB
ANJIRISJ	NNP
MAKZB	JJ
AWRX	NN
MDHIMH	JJ
IPANIWT	JJ
FMXWT	NN
FITQ	VB
FMINIT	JJ
QJBIM	NN
ERKIM	NN
FLILIT	JJ
LAKWP	VB
CMCWM	NN
MSWBK	JJ
MAPIINIM	NN
NERKIM	VB
ZAB	NN
LIMWDI	NNT
LAKWL	VB
PLQJIM	NN
ZAT	PRP
MXDLIM	NN
NICXWNWT	NN
ABDNW	NN
NRTEIM	VB
GINQWLWG	NNP
MMSDIM	NN
LNIHN	NNP
QBLT	NNT
HWAFM	VB
QBLH	NN
QBLN	NN
1,350	CD
NWIHAWZR	NNP
HWKW	VB
LHAMIN	VB
TCWGH	NN
XWLP	JJ
XILWP	NN
NDXTH	VB
ZAPJWT	NN
HWKX	VB
MBXN	NN
PJRIWJI	JJ
XWLF	VB
HMZHUT	NNP
NWZLIM	NN
ARWKWT	JJ
AIIFWWARIH	NNP
NZQQIM	VB
ELWTW	NN
XWLM	VB
XWLI	NNT
XWLH	JJ
NWER	NN
AITIXAD	NNP
FIDWK	NN
BIQWRWT	NNT
NWEZ	JJ
LHXLF	VB
MSAIT	JJ
FBWEIIM	NN
EINIIM	NN
AICJDIWN	NN
ZIKRWNWTIW	NN
LHPSID	VB
SJJISJIIM	JJ
FIDWD	NNT
SPWGIWT	NN
BRMN	NNP
MSWMN	VB
MXBRT	VB
TGWBH	NN
NWEM	NN
NELMH	VB
DIQSJRH	NNP
NITNIM	VB
XIRWT	NN
SRJIM	NN
MRWTW	NN
AWKLI	NNT
NELMW	VB
NELMT	JJ
MTIICBT	VB
IWPIE	VB
NDRFT	VB
GWG	NNP
GWF	NNT
MFJRTIIM	JJ
GRIPIN	NNP
MASIWWI	JJ
GWN	NNP
NXRJ	VB
NMNEW	VB
FANNWT	NN
NMNEH	VB
DWNM	NN
HSIR	VB
NHIGTN	NN
HDGMTI	VB
TMH	VB
PWELWT	VB
AJWMIM	JJ
5.6.67	CD
HWN	NN
MHPKNIT	JJ
LHPSIQ	VB
ERIMWT	NN
DBRI	NNT
EQRWN	NNT
ASIRI	NNT
NSIK	NNT
HWD	NNT
NJH	VB
MDIWM	NN
IDIDWT	NN
MIRBIT	JJ
MFI	NN
NJW	MOD
TPWXIM	JJ
EIRAQIM	NN
LPSWQ	VB
NFRPH	VB
EQRWT	NN
0007	CD
SPWRJAI	NN
0003	CD
XBRWT	NN
LWXIWT	NNT
TERIPIM	NN
SIKWMW	NN
N	NNP
IIQRH	VB
HBJIX	VB
IWRDT	JJ
HSIE	VB
MNWXH	NN
HPSDI	NNT
HTIIXST	VB
MWCAH	NN
MEMSH	NN
GRGRIM	NN
LAXD	NNP
HADRTW	NN
QJGWRIWT	NN
LAXR	IN
BSIS	NN
LHDHIR	VB
RWI	NNP
QBILH	JJ
TKNIWT	NNT
EIR	NN
RCX	NN
CPWPH	JJ
SIBIT	NN
RCW	VB
HTBJAWIWTIH	NN
IWWTRW	VB
PAWSJ	NNP
QWRDRWI	NNP
RCH	VB
LDWN	VB
TQFWRT	NN
ZWNWT	NN
MEMIDH	VB
EIN	NN
PQWLJH	NN
HFTKNEH	VB
MINISJRIALI	JJ
TRGWMW	NN
FIDWRI	NNT
FAR	NN
NXRT	NNT
FXQNIM	NN
FXQNIH	NN
TIAWM	NN
TIAWR	NN
BXWR	NN
FXQNIT	NN
FBWE	NN
MFWEFET	JJ
FAL	VB
BQNAAR	NNP
FAB	VB
RWT	NNP
IWGF	VB
NLMD	VB
SIBIM	NN
XWSIINI	NNP
KIPWRIM	NN
XQLAIIM	JJ
MTBHRIM	VB
PLAJINI	NNP
MZWMN	NN
BWLJIM	JJ
003	CD
002	CD
001	CD
HTBCE	VB
007	CD
006	CD
005	CD
004	CD
008	CD
TXBWLH	NN
RWEI	NNT
PRSPQS	NNP
PINI	NNP
PINH	NN
NMSR	VB
MIDH	NN
BWRXS	NNP
BIWB	NN
MIDE	NN
LKLWT	VB
SWWILIH	NNP
KINTH	VB
MFPIE	VB
MCIIRIM	VB
LKLWK	NN
WEDWT	NNT
LKLWL	VB
LBNH	JJ
MFPIL	JJ
LHSTIR	VB
MFTXRR	VB
PINT	NNT
AIFRH	VB
MAPFRT	VB
FWKNE	VB
CCW	VB
761	CD
LHCHIR	VB
SPWRJIBI	JJ
BWQARFJ	NNP
FWKNT	VB
AIFRR	VB
FXP	NNP
EMIDIM	JJ
IIRGEW	VB
PIH	NN
XRPTM	NN
MRQM	NN
PIL	NN
FLIX	NN
FEWT	NN
SMKWT	NN
MTWSKL	JJ
BIJWLW	NN
HSTKMH	VB
EIBWD	NN
HFTME	VB
HFTMF	VB
FXIH	NN
WWIZH	NNP
LFQWL	VB
FEWN	NN
FNTIIM	NN
PIW	NN
KEBWR	IN
DILMH	NN
PI.	NNP
FIEMWM	NN
IXTWM	VB
SIKWNIM	NN
FWXJ	NNP
TPILH	NN
IEBIRW	VB
TPILT	NNT
FWXR	NNT
ZIID	NNP
IRXIBW	VB
HWLKIM	VB
FWXX	VB
FQRIWT	JJ
ZIIN	NNP
HZDHWT	NN
AWWRJWN	NNP
SKWMI	NNT
MAIR	NNP
IELIL	VB
KRGIL	RB
PIRWF	NNT
15.459.00	CD
LFXZR	VB
GBWH	JJ
PWLIJWRH	NN
QDWFTW	NN
TXZIWTIW	NN
XRWN	NNT
ABWTIW	NN
GRWF	NN
MINHL	NN
IBJA	VB
GRWE	JJ
GJW	NN
MWX	NN
XRWC	JJ
XRWB	NN
QRBTM	NN
GRWS	NNP
HTIIFBWT	NN
DGLW	VB
TZRZNH	VB
2,734	CD
MWJ	NNT
RWSI	JJ
BWRRWT	NN
MWL	IN
QWRAWT	VB
NWP	NN
HTIIMRW	VB
MRCDS	NNP
AMN	NN
AMA	NN
HTPTX	VB
AMF	RB
TTEQF	VB
JLWWIZIH	NN
LNKWT	VB
EIRAQI	JJ
NWN	MOD
AMR	VB
AMT	NN
AMW	NN
LDRWF	VB
MTBCET	VB
MXBLIM	NN
XIPWFIH	NN
DWRWT	NN
XIPWFIM	NN
MTBSS	VB
DWRWN	NNP
GRACIH	NNP
HFTXRRH	VB
BILWII	NNT
HSRJWT	NN
HCBT	NNT
WIIL	NNP
AMINWTM	NN
14.46	CD
77	CD
SPRWTIIM	JJ
IRIDWT	NN
MMWCE	NN
75	CD
TBEW	VB
GZRI	NNT
TBEH	VB
LRKFW	VB
REWLI	NNT
LQIIM	VB
HZDHW	VB
LXQWT	VB
LXQWR	VB
71	CD
ZILWNI	NNP
HWDTH	VB
XIPWF	NN
KBDI	JJT
70	CD
GNIN	NNP
HGET	NNT
0507	CD
3,100	CD
ZABIM	NN
XWFBIM	VB
HNET	NNT
ALXIAT	NNP
EJW	NN
EMDTW	NN
BXRIIN	NNP
NICXWN	NN
WRIACIH	NN
SJRIAWJIPIT	JJ
SWMKIM	VB
BIWKIMI	JJ
WWRIIRS	NNP
NISWX	NN
MFPXTIT	JJ
78	CD
IWWNIWT	NN
RFAIT	VB
MEMD	NN
XCIIT	NNT
SWLJN	NNP
MNWI	NN
THIINH	VB
MINWI	NNT
HAJH	NN
AWPNTI	JJ
MNWS	NN
SIMPJWM	NN
NCXWNW	NN
MNWX	NN
HTPREW	VB
LHZKIR	VB
ABIMWR	NNP
TAWCH	NN
EPIP	NNP
JWNIM	NN
LIBRALIM	JJ
MPTIEH	JJ
MENIINT	JJ
MAWXDIM	VB
GDWLWT	JJ
QIWWI	NN
QIWWH	VB
MXJIA	VB
HTMWDD	VB
JARSWB	NNP
NPFM	NN
ICQH	VB
HXLIJ	VB
HWCBW	VB
HWBSH	VB
MXJIM	NN
QBWE	JJ
HPRT	NNT
LKPWT	VB
HXLIP	VB
CRPT	NNP
HZMNTW	NN
IMMF	VB
HPRF	NN
EWNWT	NN
4691	CD
NWTRIM	VB
HWKNSW	VB
ZIKRWN	NN
IIZWM	NNT
TW	NNT
TT	MOD
HICQWQ	NNP
GWMI	NN
A.	NNP
TL	NNT
TM	JJ
NWSDH	VB
MWRKBIM	JJ
MTQIIMT	VB
MAMNIM	NN
NICWC	NNT
MWBLJT	VB
HWLIDW	VB
AB	NN
QRQWB	NNP
AD	NNP
LJINW	JJ
AI	MOD
AK	CC
EMNW	NN
AM	IN
AL	IN
ICIBH	JJ
AN	NNP
NKLLW	VB
AS	NNP
CLIINIM	NN
AT	AT
AW	CC
ISRB	VB
MPRGNIM	VB
AZ	RB
AIMAM	NN
MTMCAT	VB
NXFWL	NNT
KRWKH	VB
QWDMTH	NN
LHQNWT	VB
IRIBWT	NN
EICWMIM	NN
MWSR	VB
HTNXM	VB
HWKRZW	VB
ECWRIM	VB
CHRIIM	NN
9691	CD
AKZBH	NN
RK	JJ
MSIRT	NNT
TBIETM	NN
ENWWH	NN
TBIETH	NN
FALT	NNT
TIAWRI	NNT
IZIN	VB
FALH	NN
AWBSSIWT	NN
IDRF	VB
ALQJRWNIT	JJ
IKWL	VB
IWSI	NNP
MIWXDT	JJ
IWSP	NNP
yyCLN	yyCLN
IWSR	VB
MEUC	NNP
TAWR	NN
THIWTIW	NN
MIRWMIT	NNP
NIKRIM	JJ
JQSJIM	NN
MAMRK	NN
MPQIE	VB
KBDWT	JJT
1791	CD
APRN	NNP
TGEW	VB
BXIRTM	NN
LHFTKR	VB
LBWFWT	VB
BECM	RB
BRNE	NNP
KIPWT	NN
FRPH	NN
MAMRW	NN
HRXBT	NNT
GIBWFN	NN
LGRWR	VB
MIKAIL	NNP
NICWL	NN
AZKRWT	NN
LHWDWT	VB
ARNHM	NNP
NEDRWT	VB
LGRWM	VB
HRXBH	NN
ZWEMIM	JJ
6591	CD
MWCHR	JJ
RAIWNWT	NN
MTARGNT	JJ
HQCIBH	VB
MCXH	NN
GILRDI	NNP
BLTI	MOD
FZWRIM	VB
BKIIH	NN
EWMRI	NNP
DIEH	NN
CDUL	NNP
HMLCTW	NN
AIMWNIM	NN
MWELIT	VB
EIBWRW	NN
LTPWF	VB
QLASIT	JJ
TEMWLH	NN
MGBLWT	NN
XWLCWT	NN
PTWX	JJ
GBINH	NN
GFMIM	NN
PLIMWT	NNP
DIRBNH	VB
LWQX	VB
KIWWN	IN
MQRR	JJ
ITBSS	VB
EMIAL	NNP
HTPJRWT	NNT
LWQH	NN
MQRA	NNT
AWLM	CC
MQRH	NN
AWLI	RB
LAWMI	JJ
EWZ	NNP
IIWWTRW	VB
QLGSIW	NN
SRJI	NNT
SRJW	NN
FQWPH	JJ
LBSS	VB
MBNIM	NN
RWZNJL	NNP
IAXR	VB
LXWQR	VB
DXWPH	JJ
TIKWNIT	JJ
IWCEW	VB
HGFTI	VB
TIMNXIH	NN
RWFMIM	VB
DWKNIAN	NNP
AIMHWT	NN
LSPR	VB
LSPQ	VB
EWINWT	NN
FRIQT	NNT
XWTMW	NN
TQFWRTIT	JJ
LHRXIB	VB
XWTMT	NN
AINPLCIH	NN
MTNHL	VB
HWFMJH	VB
MZGN	NN
BAS	NN
KIFWRI	NN
MFNIIM	JJ
LILIAN	NNP
DWXUWT	NN
ASPH	NN
IIFARW	VB
ASPW	VB
BSISH	NN
ASPR	VB
TLKID	NN
AGPIM	NN
HCMDH	NN
NWCX	VB
HGDRH	NN
MTIIXS	VB
NWCR	VB
EBRW	VB
MTWSKLIM	JJ
EBRI	NNP
EBRH	VB
NWCL	VB
MFTRK	VB
RZH	JJ
MWKRT	JJ
BEQBWTI	IN
HGDRT	NNT
WAFINGJWN	NNP
AIKWIWT	NN
150	CD
EFWIIM	VB
MWCEWT	JJ
IHNH	VB
NWCRIIM	JJ
PCWE	JJ
MARH	NNP
FWNWT	JJ
XFBNW	VB
MARQ	NNP
MARS	NNP
AGRIGANJW	NNP
JWJNHAM	NNP
LDET	VB
MPQX	NN
TFEH	CD
HRJBT	NNT
XLWMWTIW	NN
XJAW	NN
GRPIJI	NN
MPELI	NNT
KWTNH	NN
RAGIB	NNP
PLFTINAIT	JJ
AQZISJNCIALISJI	JJ
ZWHRIM	JJ
PLFTINAIM	NN
TIKNNW	VB
AIBRIM	NN
HLWWIITW	NN
MPQD	NNT
MFRTIM	VB
ASIPT	NNT
NHG	VB
MWKRXIM	VB
ARGEH	NN
HIW	AUX
AWLIMPIIM	JJ
MWZRH	JJ
BNQAIT	JJ
NHI	NN
RIBWIN	NN
QNAH	NN
HIA	PRP
NCWLT	NN
DWDH	NN
SJIB	NNP
NHR	NN
HIH	AUX
SJIM	NN
EQRIM	JJ
ASIPH	NN
SWGRWT	VB
EQBIM	NN
TISKWL	NN
AZNIHM	NN
FIPWC	NNT
METIR	VB
MEWNIINWT	VB
ARIZH	NN
AXRAI	JJ
ZHWTM	NN
HGFNW	VB
IPRCW	VB
IKWLT	NN
FDRT	NNT
AQDMAIM	NN
MILWAIM	NN
MGDL	NNP
GZIM	NN
GZIN	NNP
QIIMIM	JJ
HRMT	NNT
TPWS	VB
FIBFH	VB
MSPQ	VB
MSPR	DT
MAMCIW	NN
EWINT	JJ
MGIEH	VB
RWPP	JJ
SWTRWT	JJ
FDRH	NN
CNIEWT	NN
QIQ	NNP
HXWDF	RB
XSRI	NNT
KBIKWL	MOD
BRKIH	NN
HENIQH	VB
HZRMT	NNT
BRBWR	NN
HENIQW	VB
XSRT	JJT
XSRW	VB
PGMIM	NN
RWBIN	NNP
RAF	NNT
ALUM	NNP
EQWBH	JJ
QMIJIM	JJ
AWMLLIM	JJ
LBW	NN
MIIECT	JJ
XBRWN	NNP
HWDET	NNT
SWERT	JJ
EIWWT	NN
RAH	VB
RAW	VB
NPJLIN	NN
LBD	RB
SMIM	NN
LBF	VB
LBH	NN
LBK	NN
LBM	NN
FGB	NNP
LBN	JJ
MRPST	NNT
KIRWRGIM	NN
FALWT	NN
TQCIBIWT	JJ
MQDFT	VB
BFL	IN
ISIIEW	VB
BFR	NN
IIXTM	VB
NINWXIM	JJ
MNDIM	VB
ALAN	NNP
022	CD
HTNPLWT	NNT
ZHWIWT	NN
HWRJWN	NNP
TMIHH	NN
BIQR	VB
SNAJWR	NN
PRISTH	NN
MNCSJR	NNP
SDNH	NN
IWGIN	NNP
MFJR	NN
HFQET	NNT
GWBFH	VB
TWRGMW	VB
BIQF	VB
MJENIM	NN
LGLWT	VB
SDNT	NNT
IKINW	VB
IFRJJ	VB
IMFIK	VB
GRWNDMN	NNP
IFW	NNP
NFARW	VB
IFR	RB
MGMGM	JJ
27.90	CD
TEFH	VB
701	CD
IFE	NN
TBQF	VB
TPWQTW	NN
IFB	VB
AIFTI	NN
IFN	JJ
FRDW	VB
HKRXIWT	JJ
CED	NN
BQRWB	RB
LHCEID	VB
IIRDW	VB
HKRXI	JJ
AWPPT	VB
EWMDWT	VB
LLKLK	VB
CER	NN
CEQ	VB
MMLAI	NNT
NPSDWT	JJ
MPLGWT	NN
CADQ	NNP
RWWQIM	NN
QAMRI	NN
AXWZ	NN
HWFLKH	VB
LEWMT	IN
MIBNH	NN
LKIF	NNP
52.05	CD
HWFLKW	VB
LGWNN	VB
MTWARIM	VB
149	CD
MXDLIH	NN
WNQAJRMAN	NNP
PWQDWT	VB
ARWK	JJ
MFMETI	JJ
KFLWNN	NN
ARWN	NN
HFIGW	VB
HEDT	ZVL
AHBWT	NNT
BIQWRTIT	JJ
HEDR	NNT
SJRAWS	NNP
HKLLT	NNT
MQIIMWT	VB
RBIN	NNP
RBIM	JJ
HFIGH	VB
RBIC	NNP
RBIB	NNP
LXSWM	VB
MLIWN	CD
AWIBINW	NN
DQIQWT	JJ
HAFIMW	VB
FIINR	NNP
HWZMNW	VB
MUR	NN
IWFLMW	VB
RWQX	NN
HXFDH	NN
NHWG	VB
GWLDING	NNP
BRIWN	NN
MWWTR	JJ
QDMNI	NNP
HFBT	RB
HAFIMH	VB
KDWRGLNIM	NN
HIBJ	NN
ASR	VB
BZMNW	RB
PNIITI	NN
HBINH	VB
NISIWNH	NN
CRPTIM	NN
NUL	NN
SAWTHMPJWN	NNP
EFRWT	CDT
CRPTIT	JJ
ASD	NNP
FWBW	NN
ASI	NNP
PNIITW	NN
LHIGBWT	VB
LNXWT	VB
NZIRWT	NN
LJFJF	VB
QCRH	JJ
CRIKIM	VB
IKRIE	VB
HRFETM	NN
R	NN
IEZBW	VB
QBLW	NNP
FWLLIM	NN
DUR	NN
XRIPWT	JJ
XWRB	NNP
ARGWNIT	JJ
MBWDD	JJ
APWDI	NNT
PRWF	NNP
XBRH	NN
MXDF	RB
AXDIM	JJ
XBRK	NN
PRWE	JJ
JIPWS	NN
JIPWL	NN
ALSJR	NNP
NPFH	NN
NPFI	JJ
XBRW	NN
RICRD	NNP
BRIHUM	NNP
QBWCWT	NN
HZHIRH	VB
KBFH	VB
IMWQM	VB
FIAW	NN
GINWI	NN
CRKNWT	NN
RAINW	VB
MZWINT	JJ
AXRIWT	NN
MXLIM	VB
MRBK	NNP
LHFTBC	VB
TFIEIT	JJ
BAIM	VB
BAIN	IN
LHERIK	VB
RWQ	NNP
FIIK	JJ
LHPK	VB
MGMTIT	JJ
IIAMR	VB
HBNTI	NN
KWR	NN
2.5	CD
KWX	NN
ZANW	NNP
TWKNN	VB
QWBET	VB
MAZNIIM	NN
ZANR	NN
QFIF	NN
MEKB	VB
0001	CD
KIMIQLIM	NN
HDXWT	NNT
MWFBI	NNT
QFIM	JJ
BHEDR	IN
HDGMT	NNT
QFII	NNT
KTBWT	NN
EWBIW	NN
TWKPL	VB
TIBH	NN
FIQAGW	NNP
ASPIRIN	NNP
BEIQR	MOD
XWLQ	VB
TFWRH	NN
GNRAL	NN
LFTWT	VB
NCBRW	VB
TFWRT	NNT
IDBRW	VB
MWSIQLIT	JJ
4,509	CD
TXSR	VB
SNGWRIWT	NN
EWNFM	NN
MPLIAH	JJ
ECWR	JJ
ECWM	JJ
XIFWBI	NNT
GIMWR	NN
QRIINR	NNP
TIALC	VB
IICA	VB
GBIEI	NNT
QBUH	NNP
ECWB	JJ
HSBRIM	NN
RAWWTNIT	JJ
KRISJI	NNP
KRISJH	NNP
DWIDI	NNP
MTRWEE	VB
MWSJ	NNP
LIL	NNT
MBXR	NN
LPIIS	VB
MASIWWIT	JJ
IQIMW	VB
EWLWT	VB
RWSIM	NN
ADMH	NN
HWDI	JJ
RWSIH	NNP
MWSA	NNP
FMALNIIM	JJ
EMLT	NNT
TPIST	NNT
120	CD
NAIM	JJ
AXRWNWT	JJ
MKRSMIM	VB
126	CD
CMXIM	NN
ADMT	NNT
IEZRW	VB
RWSIT	JJ
KIRSMW	VB
AZHRH	NN
KLLIWT	JJ
JRWRISJI	JJ
AIMCH	VB
GWRLN	NN
TNAIH	NN
TNAIM	NN
GWLMI	JJ
ZLZWL	NN
ICWIN	VB
LIP	NNP
AIMCW	VB
MRWWIXWT	VB
DLHI	NNP
MHN	QW
HWCANW	VB
LIR	NNP
TGWBT	NNT
QIDMW	VB
1994	CD
MSPRWT	VB
HWBILH	VB
HWBILW	VB
AIWM	NN
MMLA	NNT
TIERK	VB
KRJST	NNT
AQDMIT	JJ
MKWWNT	JJ
LXZQ	VB
MXZIQI	NNT
MXZIQH	VB
KDWMH	RB
PWGI	NNP
PSQH	NN
DINMIJ	NN
HERCH	NN
PGEH	VB
MWSP	NN
PNXSI	NNP
PGEW	VB
TWPC	VB
HERCT	NNT
AMCEI	NNT
NJWIH	JJ
JIMIFWARH	NNP
PWGM	VB
MTKNTIM	NN
PISGH	NN
IBFIM	JJ
IAIR	NNP
FAIBH	NN
MDIDH	NN
EWNFIN	NN
BAXRWNH	RB
HWRIH	NN
ATIQH	NN
NTINIW	NN
HWRIM	NN
HWRIF	VB
AMRIQAIM	NN
FWIICR	NNP
MJWSI	NNT
MEWRBT	JJ
SWDIWT	NN
ELIAWP	NNP
MFKNET	JJ
MKFPWT	NN
ERBII	NNT
ERBIT	JJ
BWDQIM	VB
ZWEP	VB
NQIWN	NN
AMRIQAIT	JJ
QDWMWT	JJ
GLAWQWMH	NN
IXIDWT	NN
NWED	VB
LHFLIK	VB
LHFLIJ	VB
HRGIFH	VB
XPCM	NN
LRPA	VB
HEIRH	VB
RHIJWT	NN
QWNCNZWS	NN
SDRH	NN
SLIDH	NN
HKFILW	VB
AWRTWDWQSIT	JJ
QDNCIH	NN
ZHW	PRP
ZIKRWNWT	NN
JRXW	VB
AGAJ	NNP
MXWQQIM	NN
XQIRT	NNT
HEFRH	NN
XQIRH	NN
IKTWB	VB
MXLQT	NNT
AWRTWDWQSIH	NN
SIRWBW	NN
LRKWB	VB
AWNW	NN
LRKWF	VB
BKIRIM	JJ
HFLKWTIH	NN
NIRNBRG	NNP
ZRMIM	NN
XFMWNAIM	NNP
HFLKWTIW	NN
MTNGFWT	VB
FIXH	NN
SIRWBM	NN
31.3.90	CD
RAFM	NN
QPSPQW	ZVL
RAFI	NNT
RAFH	NN
LBQF	VB
BRADPWRD	NNP
BILH	VB
MWLWQWLWT	NN
RAFIWT	JJ
RAFW	NN
MSTWDD	VB
ALIWJ	NNP
LBQR	VB
BXINTW	NN
AWLMRJ	NNP
119.90	CD
NWRAH	JJ
AIFIM	NN
CRKIH	NN
AIFIT	JJ
PIRZWL	NN
BXINTM	NN
SIMNW	VB
GRIMT	NNT
NIDAL	NNP
BXINTH	NN
CRLJWN	NNP
QWPT	NNT
HBJXTW	NN
AWSIFQIN	NNP
CRKIM	NN
MGDLIM	NN
HWGH	NN
ANW	PRP
HWGN	JJ
NAKLIM	VB
LAFWRM	RB
MHWTIIM	JJ
EMIDWTW	NN
QJNIM	JJ
QWPL	NNP
JQS	NN
EQIBA	NNP
JIBW	NNP
IEWRRW	VB
XNKH	VB
AIJIIM	JJ
RWPPT	JJ
PJRIWJIWT	NN
FIM	NNT
BNJWB	NNP
BRIT	NN
MBKRIM	VB
GINGIS	NNP
QWLNWE	NN
NBNTH	VB
MWKTR	NN
NZIPH	NN
MIEWJIM	NN
MXZIQ	VB
MNGNWNI	NNT
EFWIWT	JJ
MXZIR	VB
ABINTN	NNP
MMWSDT	JJ
DIRQJWRIM	NN
BPNI	IN
NWAM	NN
LIIB	NNP
150,000	CD
GRWN	NN
PQISJAN	NNP
MWSGR	JJ
KDWR	NN
BD	NN
BF	NNP
49.80	CD
BA	VB
KWTLI	NNT
BL	NNP
BN	NNT
BI	NNP
RPIX	NNP
BT	NNT
MRQDW	NNP
JPXWT	NNP
IBWJL	VB
BQ	NNP
BR	NNP
EIRAQIIM	JJ
MRAIIN	NN
HFKBTI	VB
HBEWTIHN	NN
BLJH	NNP
NMNIM	VB
LCRP	VB
DIRH	NN
LPRJ	VB
RWJACIH	NN
7,000	CD
QIWWITI	VB
CIWWTH	VB
INCIX	VB
PMGWSJH	NNP
MSLWLIM	NN
MTKTF	VB
HKI	MOD
MXWIBWT	NN
HKL	NN
IGDL	VB
HIKRWT	NN
DMWGRPIT	JJ
LTRWM	VB
NSMK	VB
HTQRB	VB
AIXWI	NNT
AIXWL	NN
FILWB	NN
HTNGFH	VB
NQWDWT	NN
AIXWD	NNT
RDWAN	NNP
261	CD
PGF	VB
AIXWR	NN
WDAWT	NN
HFQPWT	NN
JIWLI	NNT
HISJWRIWNIM	NN
LATR	VB
RWMLIH	NNP
SQR	NNT
QRDIWLWG	NN
MSRB	VB
XWLFH	NN
QIWWTH	VB
ETIDI	JJ
SQI	NNP
IKWLNW	VB
ISWDW	NN
HRKB	NN
MAXDIM	VB
GWP	NN
LHRFIE	VB
DIWN	NN
MTAM	NN
AWRGN	VB
TAGID	NN
ZEMW	NN
987	CD
DWWX	VB
MFHW	NN
RWPAI	NNT
IQBLW	VB
KAL	IN
DIWQ	NN
DIWR	NN
KIFLWNWT	NNT
TMK	VB
ALWN	NN
AWDWT	IN
HGIEH	VB
EMWDI	NNT
IFBW	VB
MQBLI	NNT
KTMIM	NN
GBWHI	JJT
GBWHH	JJ
AQDXW	NN
HGIEW	VB
LLA	IN
DLIIM	NN
SEIPIM	NN
HELAWT	NNT
BIBIM	NN
ASISJIM	NN
MJLJL	VB
FIDRH	VB
BDI	NNT
HZNXH	NN
BDQ	VB
SQIRH	NN
LIAWR	NNP
ESQWT	NN
045	CD
JBEWT	NN
NJF	VB
LENIIN	VB
MWPNIM	VB
GWNIM	NN
XISWNIT	JJ
AWZNIW	NN
HELATM	NN
PIBW	NNP
ITQWP	VB
BISS	VB
TIPSQ	VB
LZMN	VB
HPTET	NNT
LHSTMK	VB
HTREMTI	VB
LKBWT	VB
HGWNH	JJ
BITIWT	NN
NBWK	VB
AINJLIGNJIT	JJ
HFTKNE	VB
MBNI	NNT
AWBIIQJIWWIT	JJ
IDW	NN
IIFWBI	NNT
GLWIWT	JJ
IDM	NN
5.22	CD
IDH	NN
IDI	NNT
ZWL	JJ
HWA	PRP
XMSIN	NN
AWKLIM	VB
WWFINGJWN	NNP
MCJRPWT	VB
PRIXT	NNT
FANDRH	NNP
HWPTETI	VB
MTAR	VB
IWCAIM	VB
FINWII	NNT
CWJJ	VB
AFTQD	RB
RWWQWT	NN
FWTQ	VB
SHRWRI	JJ
PWXD	VB
RGFWTIHM	NN
SKSWKIM	NN
PAFISJIIM	JJ
FEH	NN
EMWDIM	NN
FET	NNT
FER	NN
WWSJHAM	NNP
LHXRIM	VB
ZWG	NN
DINW	NN
HIJLR	NNP
DBRW	NN
MWECT	NNT
MWGDLIM	JJ
PWRWM	NN
MRKZH	NN
MAMR	NN
LFJWP	VB
MSWLP	JJ
MWPEL	VB
ZWNX	VB
KIPH	NN
PRNSH	NN
MAMN	NN
MWECH	NN
MAMC	NN
RWWX	NN
GRST	NNT
IBNH	NNP
EINW	NN
NEWC	VB
GRMNISJ	NN
MSR	VB
ERMWMIWT	NN
PRSWMT	NN
FKIR	NN
RWWI	JJT
GRWJSQI	JJ
MSK	NNT
FINTH	VB
DXWSH	JJ
HREIPW	VB
MSE	NNT
HAWJWN	NNP
SIWM	NN
MBQIEIM	VB
GRSH	NN
GRSI	NNP
AQS	MOD
MWNIT	NN
SPRJQ	NNP
MWNIM	NN
KXWF	JJ
MGNJIT	JJ
KXWL	NN
WILIAM	NNP
AQJ	NN
DWR	NN
LQRWT	VB
DWQ	NNP
MFLIM	NN
LHTQIN	VB
BSISIWT	JJ
RWBLIM	NN
MWKRWT	JJ
FLMH	NNP
SXWR	NNP
MGWNH	JJ
GLIL	NN
GLIM	NN
EWLMI	JJ
BRNZWN	NNP
GLIQ	NNP
LQRWA	VB
DWD	NNP
MIIDIT	JJ
DWN	NNP
NRAIM	VB
DWM	NNT
ARNQW	NN
AMTNIIM	JJ
SWBIIJIM	NN
EQIP	JJ
MMMNIM	JJ
ABHWTW	NN
HSTKM	VB
ITRWN	NN
ITRWM	VB
MXFB	NN
MCRIWT	JJ
IIMKR	VB
GWNI	NNT
WWIMBLDWN	NNP
TQLWT	NN
HFPET	NNT
HTLQJW	VB
SWKNI	NNT
HWFTLW	VB
345,000	CD
KRM	NNP
ANIMCIH	NN
ISWDWT	NN
MWQDI	NNT
ISWDI	JJ
HFPEH	NN
MWQDM	JJ
SRJNIIM	JJ
HTXRW	VB
HWNHGH	VB
PEILWTM	NN
NWTNT	VB
NLWWH	VB
PEILWTH	NN
HMFKH	NN
SIPWRIM	NN
HWXRMW	VB
HMFKT	VB
ERD	NNP
SIPWRIW	NN
SWCIALI	JJ
AQDMIIM	JJ
AMINH	JJ
TPQIDW	NN
HTIIXSW	NN
HWNHGW	VB
IFIMWN	NN
CIGLHAWZ	NNP
ABWLWP	NNP
RWAIM	VB
QLIEH	NN
MEIN	MOD
HLWWAWT	NN
HANA	NNP
KLKLNIM	NN
MEID	VB
PGW	NNP
LPGWE	VB
JIBM	NN
NCRWT	NN
RCBSQI	NNP
XLWMWT	NN
RFWM	NN
QIBWCNIQ	NN
MCRIM	NNP
NITWXIM	NN
MPWRSMIM	JJ
ENIINH	NN
EGWMIM	JJ
MWBARQ	NNP
BWSJWN	NNP
ZMIR	NNP
NIWWKX	VB
MDBIQIM	VB
RIMWNIM	NN
GWJPRID	NNP
WWILWN	NN
BDQW	VB
TESWQH	NN
DWWI	NN
JRNSPR	NN
SIWWG	NN
2,200	CD
XWMRTH	NN
TLMWDIT	JJ
IRWQNW	VB
PBRWAR	NNP
AWSJRWBSQI	NNP
AIKWT	NNT
AEIR	VB
IFRALIIM	JJ
QWMI	JJ
QWMH	NN
TXDL	VB
IPWT	NN
QWMT	NNT
PWLIJIT	JJ
GWRBI	NNP
XIWKW	NN
GWIS	NNP
REILIM	JJ
IQRAW	VB
HWNAH	NN
BLWMNJL	NNP
MEWRB	JJ
MWKR	NN
XWBBNIWT	JJ
LBDWQ	VB
HTBJLH	VB
MEWRH	VB
DWMLIH	NNP
MNIWT	NN
MEWRR	VB
QWRWZIH	NN
HBDL	NN
PRSJIGQWSMJIQS	NNP
100	CD
MWKN	VB
MWKI	JJT
104	CD
ATIWPIT	JJ
IMNIIM	JJ
MFKNE	JJ
LHTRGF	VB
XWLIM	NN
TWKNIWT	NN
LWWIWT	NN
AGWZI	NNT
MFKNH	NN
IIQBEW	VB
KLKLT	NNT
MTMDT	JJ
QISRIH	NNP
MTQNIM	VB
SPRWTI	JJ
ENNIM	NN
HPRDH	NN
RWIJR	NNP
ANWFI	JJ
ANWFH	JJ
LXDD	VB
LXDF	VB
MGWNIM	JJ
EIIPWT	NN
10000	CD
EWRRIN	NN
MERKH	NN
XWMH	NN
EFWI	VB
HWTQPW	VB
TWRQ	NNP
TWRM	VB
EFWR	NN
TWRN	JJ
HWTQPH	VB
TWRH	NNP
BINWI	NN
PQWLJWT	NN
GBWLWT	NN
XISKWN	NN
WRWN	NNP
IBFWT	NN
MEMDH	NN
BWF	NNP
PIRSWN	NNP
XFWBWT	JJ
MAMNW	NN
AWDN	NNP
GSIQH	NNP
MAMNM	NN
MAMNI	NNT
MZRIMIM	VB
HTRFMNW	VB
TGBR	NN
MEMDW	NN
HWRKB	VB
TGID	VB
TGIE	VB
TGIF	VB
TGIB	VB
ARWJIQH	NN
GWBRIN	NNP
QWDRI	NNP
JWRPDW	NNP
LHKRIZ	VB
XWDFIM	NN
MWCLX	JJ
XTIMH	NN
AIDIAWLWGIIM	JJ
XFBWNH	NN
FIEWL	NN
EWQBT	VB
LHTXIIB	VB
MKNIM	NN
BWDDWT	JJ
LHPWK	VB
10,000	CD
IKWLTN	NN
ZWJR	JJ
FIEWR	NN
XFBWNW	NN
XMWRWT	JJ
RALP	NNP
DIPLWMJIWT	JJ
MXPF	VB
QMXI	NNP
JKNWLWGIH	NN
CDQH	NN
IRIB	NN
CDQT	NNT
EZRH	NN
BIWLWGIH	NN
ZWWEH	NN
SIRNWT	NN
IPWRSM	VB
QBWEWT	JJ
TFXRR	VB
CMIXH	NN
NWJRDM	NNP
TQRIWT	NN
AWHL	NN
WWCRNAIH	NNP
AWHB	VB
AWHD	NNP
PJRWLGZ	NNP
BINI	IN
FWLXIM	VB
SDWM	NN
LBWA	VB
QRIJIWT	JJ
LBWF	NN
BWHQIM	JJ
NHWGIM	JJ
QRWBWT	JJ
LHSTPX	VB
685	CD
HLBFH	NN
BINW	NNP
XISWL	NNT
MWFKIM	VB
HKFRH	NN
IIECRW	VB
AIZWR	NN
KPWI	VB
MINLBAIIAB	NNP
QRIT	NNT
MWLQWLWT	NN
NWKXWTN	NN
IWCAI	NNT
HRKIBH	VB
HFPETM	NN
AIZWN	NN
HWFLMW	VB
MBWGR	NN
IMWNH	VB
FAJ	MOD
PQIDI	NNT
PRF	VB
LTXWM	VB
PRC	VB
FXQNIW	NN
PRL	NNP
QWRT	NNT
ATA	NNP
PRI	NNP
QWRS	NN
MCIEIM	VB
PRJ	NN
QWRN	NNP
LHTABD	VB
NTNIH	NNP
RELH	NN
PRQ	NN
QWRH	VB
PRR	NNP
NDRFW	VB
FAN	NN
ASTR	NNP
QWRE	VB
PRX	NNP
KBIFI	NNT
QWRA	NN
HXZRT	NNT
ICIRWTIHN	NN
HTIIXSWTW	NN
HXMRT	NNT
7,685	CD
QMCW	VB
GWFIM	NN
MFJRIM	NN
PWGFT	VB
SNAJ	NN
AMRH	VB
PDRALIT	JJ
BRKH	NN
HWXL	VB
LHTRXQ	VB
TFWMWT	NN
WTIQH	JJ
PNXS	NNP
NIWQASL	NNP
AMRT	VB
AMRW	VB
HFPETH	NN
HTIIBFW	VB
KWTRT	NN
FMEW	VB
MPQDI	NNT
IMNIT	JJ
LICWR	VB
RPWAH	NN
MAXRI	IN
TPSH	VB
IRQWT	NN
MTGBFIM	JJ
HRIM	NN
LQWXH	NN
EISH	NN
IRQWN	NN
XIIB	VB
LFWNWT	NN
TPSW	VB
IXDIW	MOD
MPQDT	NNT
MEWWTT	JJ
GREIN	NN
SIAJL	NNP
DWGLWT	VB
ICWRIM	NN
RIWS	NNP
MWZNX	JJ
TERWBT	NN
QNIINIM	NN
IJILW	VB
NICWLT	NN
GAWWRILWB	NNP
NLK	VB
XUK	NN
XWJA	VB
FWLMH	VB
XWJB	NNT
MFWXRRIM	JJ
XWJI	NNT
IEILIM	JJ
DLH	JJ
DWBRWT	JJT
XWJP	VB
DLQ	NN
MCWIINT	JJ
AWJWMJ	NN
DLT	NN
HDRGTIT	JJ
XBRTIT	JJ
HTNGDW	VB
NRQMW	VB
MWGZMIM	JJ
NWCRIT	JJ
IIQBE	VB
QICWR	NNT
LARX	VB
MSPIQWT	JJ
EDWTW	NN
GZEN	NN
MTPREIM	NN
ZHWT	NN
GIHAD	NN
QICWC	NN
PKWWR	NNP
LARI	NNP
MAN	NNP
HBXIN	VB
MJHW	NN
NRQMH	VB
ERWMIM	JJ
LBIDIM	NN
MFNH	NN
FXRWR	NNT
RIALIWT	JJ
IWMIWT	JJ
TGRWM	VB
ANJMN	NNP
ZKRIH	NNP
HRWWIX	VB
SPJMBR	NNP
HXJIAW	VB
HCILW	VB
NWHLI	NNT
TRBWTM	NN
DIRTW	NN
TRBWTI	JJ
ECB	NN
RMT	NNT
NKTBW	VB
RMZ	NN
PLSJI	JJ
ECM	NNT
QAMINGS	NNP
CPIRT	NNT
ECI	NNT
LGFT	VB
FDWLT	NNT
NSXRW	VB
MWTXM	JJ
ECR	VB
LHTPWCC	VB
HSJWN	NNP
AXWZIM	NN
TPQIDM	NN
RMH	NN
RMI	NNP
TPQIDH	NN
TPQIDI	NN
TPQIDK	NN
061	CD
NLQXW	VB
RDIPWT	NN
067	CD
TQCIB	NN
FIRWT	NN
ICRNIT	NNT
PEWLWTIH	NN
AIKLSW	VB
QLIIJWN	NNP
BWL	NN
MSPIQ	VB
MGIEWT	VB
DWMWT	JJ
LBNT	NNP
QWRAN	NNP
NLQXH	VB
ARKIJQJIT	NN
MWDEH	NN
MWDEI	NNP
NPGEW	VB
QJIGWRIH	NN
NPGET	VB
MXIAWT	NNT
CEDIM	NN
EIQRIW	NN
NPGEH	VB
CINWRWT	NNT
CMWDWT	JJ
GZIRWT	NNT
MSTER	VB
MBWSSWT	VB
BGDR	IN
NBWNH	JJ
NWHLIM	NN
CNWE	JJ
TBWCE	VB
NRFMH	VB
BGDD	NNP
QDIMH	RB
IFTTPW	VB
KTWBH	JJ
SIDWRIM	NN
NPAL	NNP
LXRWJ	VB
MRKZ	NNT
MILWAH	ZVL
RENNH	NNP
DWUX	NN
GWWNIM	NN
LBWTIHN	NN
IRIETK	NN
LXRWG	VB
ELT	NN
SWRIM	NN
DMIWNIT	JJ
HIDBRWT	NN
MBJLT	VB
SWNJH	NN
XWBRWT	NN
MWPE	NN
IFTTP	VB
GRMNIT	NN
FKM	NNP
FKN	IN
FWRT	NNT
MIQWMW	NN
SIQWR	NNT
GRWFH	NN
MINHLI	JJ
FKX	VB
PNSIWT	NN
ZWKIM	NN
NICWLIM	JJ
GRMNIM	NN
FWRH	NN
MIDT	NNT
GRMNIH	NNP
AIKRIM	NN
EBDLL	NNP
MSWBSDWT	JJ
TWGBR	VB
MTBSST	VB
XWGGIM	JJ
ZWJRIM	JJ
MIFH	NNP
LHTBCE	VB
LWWIITN	NN
NISWXIM	NN
RXWQ	JJ
BIJLNW	VB
CIDWQ	NN
AWLIMPI	JJ
EILT	NNT
ASPQJIM	NN
RXWB	NNT
AINPLCIWNI	JJ
NMKRIM	VB
HFFI	ZVL
HIFG	NN
NERC	JJ
LHNHIG	VB
IWDE	VB
KWWNT	NNT
FLIJ	NN
MGUD	NN
AWT	AT
LMCWT	VB
AWR	NN
ICIBWT	NN
AWP	NNP
AWN	NNT
AWM	NNP
AWFWWIC	NNP
AHRWNWB	NNP
HWDRKH	VB
AWI	RB
LMCWA	VB
7191	CD
DIAMWND	NNP
KWWNH	NN
MPLJ	NNP
DQT	NNT
AZRXIIM	JJ
LFTP	VB
HRSNIT	JJ
DQR	VB
MEWJRWT	VB
DIRQJWR	NN
QWNPLIQJ	NN
HTIIXSWIWTIHM	NN
FBRIH	NN
NADIRH	NNP
DMIM	NN
TITQL	VB
ADIRIM	JJ
DQH	NN
MZKIRH	VB
HZDRZ	VB
QMLIWT	NN
FWNAIM	VB
ECMAIT	JJ
HWKIXT	VB
HWKIXW	VB
NPFW	NN
IWRFE	VB
RPIDH	NN
HWBLWT	NN
XMIFI	NNP
XMIFH	CD
LNGWE	VB
MILQN	NNP
ISWDH	NN
18	CD
MIFXQIM	NN
ALIPWIWT	NNT
NWPLT	VB
MCRIIM	JJ
HIKTH	VB
WIINFJIIN	NNP
DIWWXI	NNT
MINAI	NNP
BIJLH	VB
HPSQNW	VB
EWQC	NN
SLWCQI	NNP
DRWRI	NNP
TENWGWT	NN
ECMWT	NNT
AWSP	NNT
JLQWMWNIQCIH	NN
TIMFK	VB
02	CD
03	CD
01	CD
MBWKH	NN
FXQNI	NNT
04	CD
05	CD
HMFIK	VB
HSKIMW	VB
08	CD
09	CD
LISJ	NNP
XFWB	JJ
SINIT	JJ
HSKIMH	VB
XFWD	NN
PSIKWLWG	NN
HCLXTW	NN
MFPXTWN	NNP
MXUJ	NNT
BAWZNI	IN
EIWWRWN	NN
AWSJRLI	JJ
MRWKSNWT	JJ
MFWTPT	JJ
MEWZ	NNT
KPRI	NN
GWRNAL	NNP
TWFLM	VB
HWELW	VB
MNIE	NN
MEWN	NN
MNIN	QW
IZWMWT	JJ
HTQWMMWT	NN
MTARXT	VB
QWRBN	NNT
XGIM	NN
RIFWI	NN
PARIJ	NNP
GAJUJ	NNP
ALINH	NNP
TTBE	VB
LHFTMF	VB
FIJPWN	NN
MMFIKH	VB
MQWRBIM	NN
SJAZRIM	NN
LHWZIL	VB
DXWP	JJ
LHBHIR	VB
MWCRJ	NNP
LBNWN	NNP
DXWS	JJ
MXCIT	NN
QWFRIM	VB
SIMWN	NN
GWLIM	NN
SRJNIM	NN
MLIM	NN
MLIN	VB
ALBIJ	NNP
MLIH	NNP
NQLEIM	VB
MIWEDIM	VB
ICWA	NN
ZWSMN	NNP
BWAKH	NN
BWDAPFJ	NNP
EIWN	NN
DETI	NN
DETH	NN
MFPJIM	NN
DETM	NN
C.	NNP
AWFRW	VB
BXINH	NN
PRSLNI	NNP
350,000	CD
JWEIM	VB
GWWE	VB
BXINT	NNT
ZR	JJ
AWFRI	NNP
AWFRH	VB
MRKZIM	VB
MIGBLT	NNT
DETW	NN
HKNT	NNT
MWMR	NN
ADIR	JJ
CH	NNP
PICWIIM	NN
CL	NN
IPANIIM	JJ
AIKWTI	JJ
HWSIP	VB
CD	NN
01.3	CD
HGDIR	VB
BITWR	NN
AIKWTW	NN
HWMRWS	NNP
01.4	CD
CR	JJ
LMSWR	VB
KSPM	NN
CW	NN
QWBNIT	JJ
KSPH	NN
KSPI	JJ
TIIRIM	NN
IMNIWT	JJ
NFIAT	NNT
NAMD	VB
LHGFIM	VB
NIHWLIWT	JJ
HKTIBW	VB
LAWMNIWT	JJ
NAMN	JJ
HTLBJW	VB
110	CD
NAMR	VB
HKTIBH	VB
yyQM	yyQM
ITGFMW	VB
WEDH	NN
DIIWWID	NNP
HWLMIM	JJ
SAWTHPJWN	NNP
HMWMIM	JJ
LHENIF	VB
TIKNWN	NN
HFTLMWT	NN
LXFB	VB
HWQIEH	VB
GLILI	NNP
NQIFTI	JJ
NZQIM	NN
SWP	NNT
WEDT	NNT
LHENIQ	VB
MZKIR	NNT
LWRIAL	NNP
FABW	VB
MBQFT	VB
KKL	IN
NXZH	VB
RWMAIT	JJ
LIICR	VB
MKIN	VB
MKIM	VB
MKIL	VB
MKIR	VB
MPIQH	VB
GILIWN	NNT
LIICG	VB
AINDIANIM	NN
KFRIM	JJ
FABH	VB
XIMWM	NN
HIJMEWT	NN
098891	CD
HIEDRWTW	NN
HIJIBH	VB
FLIFIT	JJ
HKNIS	VB
AIZWRIT	JJ
HERIKW	VB
IEBRW	VB
XBIBIM	JJ
GIDWP	NN
LAMC	VB
XWQIM	NN
FPWT	NN
FPWP	JJ
PRIFT	NNT
NIPC	VB
MWEMDWTW	NN
AIFIWT	NN
MNWKRT	JJ
JKNIT	JJ
FQIDTW	NN
LAMT	VB
BIMWI	NN
803	CD
AIZMIRLI	NNP
801	CD
800	CD
GIDWL	NN
FPWI	JJ
ZWHI	PRP
MXMIRWT	JJ
ZIWPIM	NN
GDEWN	NNP
KNWPIWT	NN
ZKTH	VB
ZWHR	NNP
PILIP	NNP
ERIKT	NNT
QWMPWRJ	NNP
ISKL	VB
PIPUA	NNP
AWSMNWB	NNP
ALLH	NNP
GBETI	NNP
ERBH	NN
BWLJT	JJ
QIJWB	NN
NLXM	VB
AJALNJH	NNP
MKBI	NNP
ERIKH	NN
HWNPQW	VB
HXRIMW	VB
XIBWRIM	NN
MWSJPH	NNP
EPEWP	NN
MWSJPA	NNP
BLWMH	NNP
KWABWT	JJ
MTXIIBIM	VB
752	CD
IWRFH	NN
HFETH	VB
HIPRKL	NNP
XMWT	JJ
MNIIRISJIT	JJ
NZHRW	VB
XMWR	JJ
IICWB	NNT
MWRKB	JJ
QRNWT	NNT
RABW	NNP
LWGISJIT	JJ
MILAW	VB
MWRKN	JJ
APIZWDH	NN
KFIRWT	NN
MILAN	NNP
WWRFH	NNP
PLILIIM	JJ
NKFLTI	VB
257.5958	CD
MFMEWIWT	NN
XSR	JJT
HKFLT	NNT
HGBIR	VB
LDKA	VB
MAWHB	VB
AIJIPAQ	NNP
LHIABQ	VB
HWFBE	VB
MWSJAPH	NNP
XIKH	VB
NJIWT	NN
XSD	NN
GRIIJ	NNP
QWNJIQJ	NNP
XSM	NN
KLIL	RB
KLIM	NN
KLIH	NN
CBEIM	NN
NGRS	VB
MAWFRT	JJ
PTE	RB
MCIAH	NN
CIINW	VB
CIINT	VB
NQLWJ	VB
HJBWT	NN
FJWJGRJ	NNP
CIINH	VB
CIINI	NNP
NGRM	VB
PTX	NNT
MFTME	VB
KLIW	NN
MFTMF	VB
DIAMNJ	NNP
QWLWNL	NN
MLWAH	NN
ZIRT	NNT
ZIRW	NNP
FWME	VB
MXMIRIM	JJ
LXILWPIN	RB
FWMN	NN
MDRGWT	NN
FWMR	NN
NQJEH	VB
IDIIM	NN
ZIRH	NN
MLWAW	NN
MXSWMIM	NN
HNDLZLC	NNP
TIIRT	NN
RIGWL	NN
FJXIM	NN
MWMXIM	NN
NIFWAIW	NN
TQPWT	JJ
ABRNATI	NNP
CMXW	VB
CWDQT	JJ
CMXI	NNT
HMTIN	VB
QWLJWRH	NNP
GBWL	NN
ALIEZR	NNP
NSTGR	VB
FJXIT	JJ
NTGLH	VB
PWRJR	NNP
FETIIM	NN
XRJH	NN
HRGL	NN
JBLH	NN
MWR	NNP
PNIMIIM	JJ
MPWQPQT	JJ
SUM	NN
IEDI	NNT
XRWM	NN
NELI	NNT
NELW	VB
SUS	NNP
MIFHW	NN
HRGW	VB
MEMIDWT	VB
MKTBH	NN
WWTIQWT	JJ
32.40	CD
EIQR	NNT
HTLHBWTM	NN
TPQWDW	NN
SWJIM	VB
MEFIW	NN
MEFIT	JJ
MWT	NNT
MNSRT	VB
MEFIM	NN
MMMF	VB
FAPTNWTW	NN
XRWF	NNP
GIBWRIW	NN
LPNI	IN
NBE	VB
TPQWDM	NN
PWBLICISJIQH	NN
MLXMTIT	JJ
EWCB	VB
RZRB	NNP
XWDF	NN
HWCE	VB
DNI	NNP
DNH	VB
RENN	NNP
SWHR	NN
QRIM	JJ
DNW	VB
GILWIIM	NN
TTMWDD	VB
XWDW	NN
AWMNSQI	NNP
HWCT	VB
JMBWR	NNP
BSISIT	JJ
221	CD
HWCAWTIHM	NN
SIPQW	VB
QDIFZWN	NNP
MMFLTH	NN
THIWT	NN
HQPWT	NN
EBWDTW	NN
TIQWN	NNT
QCR	JJ
HQDIMW	VB
QCP	NN
MFLM	VB
SPCIPI	JJ
XSRWNWT	NN
QCT	MOD
MFLB	VB
CWEDIM	VB
RCITI	VB
NWDE	VB
MEBRIM	NN
XWFPIM	VB
TIKWNISJIT	NN
MKSXI	NNT
KTWBT	NN
MQWRH	NN
MQWRI	JJ
LGIIS	VB
RKZ	NN
MQWRM	NN
SWLIDI	JJ
RKF	VB
MNTXI	NNT
MQWRW	NN
RKB	NN
AWMAHRH	NNP
MZLZL	VB
LGDWL	VB
RKH	JJ
LHXMIC	VB
RIQH	JJ
RIQI	NNP
081	CD
085	CD
LFEFE	VB
NFTDL	VB
MIWMNWT	NN
MTQRB	VB
ARFT	NNT
CIDW	NN
XJPW	VB
MNIXIM	VB
JQJIWT	JJ
NWR	NNP
MWPNMT	VB
BDLNI	JJ
EINH	VB
MKNSI	NNT
LHTIIXS	VB
XDRI	NNT
AINJRSIM	NN
MWDGF	JJ
JKNIQH	NN
ABIJL	NNP
MWFPE	VB
QBILWTN	NN
XWRGT	JJ
NWTNIM	VB
TWMKIH	NN
KHNIZM	NN
PRFNWT	NN
XWLQIM	VB
TWMKIM	VB
HIFGIM	NN
BRIWNWT	NN
1.6.90	CD
IFTMFW	VB
TMIHTW	NN
NBKI	NNT
ADRIKL	NN
5.63	CD
PQWDT	NNT
MTEWRRT	VB
TWMKIW	NN
BNDWRI	NNP
PIDL	NNP
GNBWT	NN
JRIISI	NNP
APWD	NNT
NWFAWT	VB
QLJW	VB
ANFIW	NN
HTRKZW	VB
0	CD
MAWXR	RB
ANFIH	NN
ANFIM	NN
NIJRLH	VB
IGWR	NNP
FIR	NN
IFNM	VB
NKNEH	VB
NBXRW	VB
MWRD	JJ
IFNH	JJ
MWRJ	JJT
MFMIE	VB
MWRH	NN
LHSKIM	VB
MWRN	NNP
LHJ	NNP
GMII	NNP
MFMIC	VB
DIRTM	NN
FIA	NN
LERER	VB
IKBD	VB
MSMLIM	VB
IFNW	VB
QRATI	VB
NBXRH	VB
HWPKT	VB
MKWERT	JJ
MTAIMH	VB
TFTIT	NN
SSJRI	NNP
DIIBI	NNP
PISARW	NNP
MNQRWT	JJT
MAHBIM	NN
ETWDWT	NNT
TXLIP	VB
LFXRR	VB
NWXIWT	NN
XILWNIIM	JJ
TXLIJ	VB
NKNEW	VB
BIZBWZ	NN
LHPXIT	VB
TWHIM	VB
GRMNIWT	JJ
XWQH	NN
NPCEH	VB
LHZIQ	VB
BARI	NNP
LHTPLSP	VB
NPCEW	VB
MHIRI	NNT
IXLIJW	VB
NBLEW	VB
APQJIWWI	JJ
MWPFJ	NN
HSTGR	VB
IWFB	VB
NMWKWT	JJ
MCWIN	JJ
MCWIH	VB
NAMNWT	NN
3,086	CD
AWMLLWTM	NN
QWLIN	NNP
IWFQEW	VB
ANALI	JJ
MJIILIM	NN
MFRH	NN
EFRIM	CD
MRIC	VB
TIQIM	NN
MRIN	NNP
BIZARIT	JJ
MRIM	NNP
MTNDBIM	NN
MRIW	NNP
97125480	CD
JRANSPR	NN
MTQDMT	VB
MZERIWT	JJ
RXWQWT	JJ
CMXIIT	NNT
HXMCWT	NN
SIBIR	NNP
MXBR	NN
ARWASJI	NNP
KRKIM	NN
MXBL	VB
XBLH	NN
AGDWT	NN
IWRDI	NNT
SWWINDWN	NNP
HWRXQW	VB
EWSQ	VB
MZDHWT	JJ
MFTBCIM	VB
SIKT	NNT
NQBR	VB
NQBL	VB
MMTINIM	VB
BEIWT	NN
HARJS	NNP
LCBWE	VB
NQBE	VB
MIJWWX	NN
MPWSJR	JJ
RWMNIIH	JJ
AIGWDIM	NN
FBWIIM	NN
JRAC	NNP
BIJAWN	NN
FLILIWT	JJ
QTWLIM	NN
HZMINW	VB
QRIIT	NNT
SRQZM	NN
QTWLIT	JJ
RAITI	VB
MCPIM	VB
MWACT	JJ
KPPH	NN
HTXIIBWIWTIH	NN
IZMIM	NN
SIDWN	NNP
KDWRGL	NN
BNQS	NNP
DWMINNJI	JJ
MEUM	NN
MFPIEH	VB
QFWRH	VB
HPTEWT	NN
SIDWR	NN
IXIIBW	VB
552	CD
EILAI	JJ
MHWT	NN
LHDAIG	VB
QNSWT	NN
XWMIM	JJ
EFIRIM	NN
MPLGT	NNT
XBRIHM	NN
ZQIM	NN
CWWXWT	NN
QWFINSQI	NNP
MMFIIM	JJ
XWBBIM	NN
MPLGH	NN
SPWNJANIT	JJ
EIKB	VB
EFIRIT	JJ
ALIHW	NNP
NXIFWT	NN
HIERKWT	NN
DALDH	NNP
XWPFIT	JJ
HQMTM	NN
BKWRH	NN
HTNPC	VB
MLKT	NNT
HQMTH	NN
HQMTW	NN
MLKH	NN
GWLDH	NNP
GZRIM	NN
HTNFAWT	NN
AWGRSHIIM	NNP
RAFWNIWT	JJ
NWSIIBH	NNP
HFQEH	NN
AWFPZ	VB
HNHLT	NNT
BJRM	IN
MITWN	NN
MITWS	NN
LBNWNIIM	JJ
LNGX	VB
PNIWT	NN
MTXBJIM	VB
PRWPIL	NN
MFIXI	JJ
MFIXH	NN
HBINW	VB
BIBLIWGRAPIT	JJ
141	CD
MMLAH	VB
XIL	NNT
EIJWR	NN
MRKBH	NN
NHIRT	NNT
BWDQT	VB
ACJDIWN	NN
PWLIJIIM	JJ
NHIRH	JJ
NKBD	JJ
MMLAT	VB
MTEMLWT	NNT
EDIIN	RB
APFRWT	NN
MIEWJ	NN
MSTDRWT	VB
MATIW	NNP
QZAN	NNP
HDQ	NN
BNI	NNT
ISRBW	VB
HFKLTN	NN
MTXFBT	VB
NMAS	VB
JBEIWT	JJ
XIILI	NNT
HFTLJWTH	NN
NWSPIM	JJ
HWPSQH	VB
KRISJIS	NNP
SJAZ	NN
MQSIM	NNP
QAJ	NN
XIW	VB
HQFRIM	NN
LIPIN	NNP
SWBARW	NNP
HFPIE	VB
MMFL	NN
AIQH	NNP
TSBIK	NNT
MMFI	JJ
GBRIALH	NNP
GBRIALI	NNP
FLMIM	JJ
SBIB	IN
PSWQ	NN
AQJWARI	JJ
NIWWJ	VB
PIILI	NNP
LKSWT	VB
HSRT	NNT
SBIR	VB
KBDH	JJ
MFWPFPIM	NN
ANG	NNP
MKIRWT	NN
ALMNJRI	JJ
FIXZR	VB
KIMAI	NN
AXZQH	NN
LHQFIB	VB
HWRGL	VB
LIWWRPWL	NNP
LKBWF	VB
LKBWD	IN
HMCATW	NN
MWLJI	MOD
MTINWTH	NN
MTABLIM	VB
821	CD
MBJA	NN
MQWRBW	NN
AIRWPIWT	JJ
MFPJIIM	JJ
TNWET	NNT
ZKRW	NN
PAFISJI	JJ
DINM	NN
ERWBH	NN
ADMWT	NN
MZIQI	NNT
LWWDA	VB
DINH	NNP
APRIM	NNP
APRIL	NNP
DIPLWMJIM	NN
FJWIWT	NN
HDLIP	VB
HTBQFW	VB
TNWEWT	NN
ZKRM	NN
TNWEH	NN
PWNIM	NN
LWXMIM	VB
SEIP	NN
KGWN	IN
KWLSJRWL	NN
IWFBE	VB
EMWSH	JJ
EIRWNI	NNP
RMJ	NNP
SIRWBAJQW	NNP
GREINIWT	JJ
JLWIZIWT	NN
SEID	NNP
MCPH	VB
HNXTT	NNT
IWFBT	VB
GWRM	NN
TPAWRH	NN
G	NNP
PWGIMWRI	NNP
HQLH	NN
ESQNI	NNT
SAJIRH	NN
AWRWWLIANI	JJ
HGETI	VB
MWSJRL	NNP
GLRWN	NNP
FWPRH	VB
AWPWZICIH	NN
MELIB	VB
PARWQ	NNP
MWRIM	NN
MF	IN
MWRIC	NNP
JQBASRN	NNP
NERKWT	VB
PRJIM	NN
BIJA	VB
NLWWIT	VB
MELIT	NN
PRJIW	NN
PRJIT	JJ
SIEWT	NN
LWIN	NNP
DEIM	NN
LWIH	NNP
XIWNIT	JJ
LWIJ	NNP
104.90	CD
IWQJNW	VB
HBXINH	VB
TNAI	NN
AIKWTM	NN
XIIW	NN
RIBWNIT	JJ
HPEIL	VB
XIIL	NN
XIIM	NN
XUL	NNP
PRWDWRMWL	NNP
HTPREWIWT	NN
HBXINW	VB
IXZWR	VB
NPFIWT	JJ
ISD	VB
KLWT	NNT
MTXMQWT	VB
GANAJH	NNP
SWCIALISJIM	NN
QLILWT	NN
HPCRWTIH	NN
RXWBWT	NN
NDQR	VB
MPRFIH	NN
JKS	NN
LHTLQX	VB
HTEQBH	VB
WWAFINGJWN	NNP
FQD	NN
KLWM	NN
PRWJSJNJIM	JJ
APRWXIM	NN
ELIIT	NNT
CALX	NNP
SIKWIIM	NN
SIKWIIK	NN
FWKN	VB
HMNWN	NN
SRJNIWT	JJ
FRI	NNT
FRH	NNP
MCBIEIM	VB
TKIN	VB
FWKX	VB
FRR	VB
FRP	NNP
KRWKWT	JJ
MCBIEIW	NN
SIKWIIW	NN
SBWR	VB
GIAWGRP	NN
NKWW	VB
MGIFH	VB
GWMWLQH	NNP
11	CD
10	CD
13	CD
12	CD
15	CD
14	CD
17	CD
16	CD
NWKX	IN
LDXWQ	VB
LDXWT	VB
354	CD
MAZN	NNT
MAJ	NN
JHWR	JJ
LAWR	IN
NAWRLWG	NN
CNZWRH	NN
XILWT	NNT
NWKL	VB
MFMEIT	JJ
DN	NNP
DL	JJ
DM	NN
AWRNIM	NN
NENH	VB
DH	NNP
DI	RB
MGLH	VB
GAWWTM	NN
JIPWSIT	JJ
DB	NNP
SWD	NN
SWG	NN
DA	NNP
PIRMIDH	NN
SWRIT	JJ
DTIT	JJ
MRKWS	NNP
DW	MOD
DT	NN
DR	NNT
MRWBIM	JJ
DQ	ZVL
TGR	NNP
AIFWMIM	NN
MATIIM	CD
HICEIM	NN
MXIIKIM	VB
SWNJWT	NN
PFIJWT	NNT
ERBI	JJ
SPNSR	NNP
BIMWT	NN
QNIG	NNP
HKNWTIW	NN
201	CD
MSTIIDIM	VB
IXSI	NNT
ELWBI	NNT
NIMWSIM	NN
TKNIT	NN
NXLQWT	VB
IIHPKW	VB
SWNG	NNP
TKNIM	NN
XWFD	VB
WWEDWT	NNT
XWFF	VB
TKNIH	NN
XWFB	VB
IXSR	VB
MWFGIM	NN
MBWLBLIM	JJ
MAWFPZ	VB
XWFK	NN
MWLDT	NN
DIMWNH	NNP
LGMWR	VB
MMFLTI	JJ
MNEMI	NNT
BPIRWF	RB
LHTQIIM	VB
FKIRI	NNT
HTREWT	NN
MTAXDIM	VB
EBWDTH	NN
EBWDTI	NN
LGMWL	VB
MMFLTW	NN
GIRWFIN	NN
MHIRH	JJ
FGRTIIM	JJ
QJEIM	NN
MIRN	NNP
MFRT	NNT
NDQRH	VB
RWBRS	NNP
LJPLL	VB
WN	NNP
WL	ZVL
MIRB	NNT
WW	NNP
TQLWTIW	NN
MFRD	NNT
WS	NNP
WTIQIM	JJ
QAM	NNP
FIIQSPIR	NNP
QAN	NNP
RWBRJ	NNP
RCIXTW	NN
ZZ	VB
IIAWFW	NN
RIX	NN
PNJZIWT	NN
DJRWIJ	NNP
TPWZIM	NN
RIQ	JJ
IAWFR	VB
AINDWQJRINCIH	NN
RII	NNP
AMINWT	NN
RID	NNP
LABIANW	NNP
ASJRAJGIT	JJ
RISN	VB
HEDPH	NN
HAL	NNP
HAM	HAM
TRMW	VB
MHWMWT	NN
MIICR	VB
BNQ	NN
BNW	NN
MXMIC	VB
NSGR	VB
BNH	NN
IGBR	VB
NZQQT	VB
BNM	NN
98891	CD
MMCAIH	NN
MIICG	VB
HTGLWT	NN
SJAR	NNP
HAW	NNP
SSGWNI	JJ
MAPIH	NN
QIBLTI	VB
QLWT	NN
LHFTTP	VB
XFFWT	NN
LHIEDR	VB
KFRWNM	NN
MWDAG	JJ
921	CD
ALIPWT	NNT
QLWF	JJ
NGID	NNT
ISLXW	VB
HWTNTH	VB
GWB	NNP
MXWCH	IN
HELW	VB
HEDIP	VB
QJEI	NNT
MTIIXSWT	VB
NKWT	NN
RPPWRJ	NNP
NKWN	JJ
PJWCINI	NN
EJRH	NNP
HELH	VB
KIUL	NNP
MXWLL	NNT
QRTA	NNP
QHILWT	NN
QRTH	VB
HGDIRW	VB
MCEDW	NN
QWLQJIWWIT	JJ
ANWFIIM	JJ
KLIATM	NN
NXRDW	VB
MKAIBH	JJ
HTKNSH	VB
SISMH	NN
TMWRT	IN
MWTM	NN
RCPH	NN
RIHWJ	NN
BERNWT	RB
HBXNWT	NN
TWBEIM	NN
HIITI	AUX
TIAMN	JJ
IFLX	VB
CPIR	NNP
BWCE	VB
TPIRH	NN
XWCPH	NN
LERB	VB
DLIH	NNP
IFLM	VB
SISMTW	NN
MWTR	VB
JKNAI	NN
RKBW	NN
MWTW	NN
MWTX	VB
AKZRIT	JJ
XQIINWT	NN
ARMISJ	NNP
PCIETW	NN
IHDWT	NN
PILWSWPIH	NN
AGWZIM	NN
XWLPT	JJ
PFEIM	NN
TTBQF	VB
AXRAIWT	JJ
IICWA	NN
PRWWH	NN
QWNSRWWJIWWI	JJ
TMWNH	NN
AXWRI	JJ
MHNDST	NNT
HSIXH	VB
LHTNAWT	VB
MHIMN	JJ
15716281	CD
NBWKIM	JJ
MPWRJWT	JJ
ANPILD	NNP
SJIIN	NNP
NKNSIM	VB
HIJL	NNT
SJIIJ	NNP
PSJH	NN
SJIIH	NN
HSBIRW	VB
HIJB	RB
SISMT	NNT
MKLLH	NN
EBWDTNW	NN
HTKNSW	VB
NAWMIW	NN
LKPR	VB
ABDW	VB
QAWBWIIM	NN
AKPT	RB
AWJWBIWGRPIT	JJ
MRGF	VB
400	CD
PNQIIBICIM	NNP
MINTH	VB
RWDI	NNP
NPGEIM	NN
HIFWWH	VB
MLAWT	NN
AWJWBIWGRPIH	NN
MAWRGN	JJ
MTMXIM	NN
TLWIWT	VB
HWEBRH	VB
HTQLSWIWT	NN
ABDN	NNT
EWCMTW	NN
QPJN	NNT
HTGLWTW	NN
NAIWWIT	JJ
MNIWTIH	NN
XBRWTM	NN
TBWSWT	NN
LFPR	VB
NIIR	NN
CZNH	NNP
SWKMW	VB
DMMT	NNT
PRLMNJARIT	JJ
EWQBIM	VB
EWTMNI	JJ
AZWR	NN
ISWDIT	JJ
ZIW	NNP
NAMRIM	VB
LNWKX	IN
EIQRIWT	JJ
MAWXDWT	VB
HSBIRH	VB
AZWB	NN
EWUD	NN
MHPKH	NN
NCJWW	VB
LMMF	VB
CKIH	NNP
MFJXI	NNT
LEDKN	VB
LMMN	VB
BIQWF	NN
TIPQWD	NN
NWGDT	VB
EDWT	NN
HWJRD	VB
XWSKIM	NN
MEWNIINT	VB
SIIMH	VB
HBQIE	VB
KDWRSL	NN
BIQWR	NN
DQIRWT	NN
HFPEWT	NN
AWDISIAWS	NNP
XIDWFW	NN
ETIDWT	VB
JRIJWRIALIWT	JJ
XBWIIM	JJ
RCIWNALIZM	NN
CWWTW	NN
FIQWL	NNT
FIQWM	NNT
FNIIDR	NNP
FIQWP	NN
ALMNJIM	NN
0781	CD
MBXNIM	NN
CWWTI	NNT
MWNCX	VB
WWL	NNP
TFLWM	NN
NAGJS	NNP
IRWD	JJ
HTPRSM	VB
PRANSWAH	NNP
JIRWNIM	NN
SIMPJIT	JJ
XQLAI	JJ
NNIX	VB
NPRSWT	VB
SWLWDR	NNP
RGFWT	NN
BWCEW	VB
BSIWNI	NNP
PRLMNJRIT	JJ
ZRIMH	NN
XJA	VB
DISQIM	NN
SIIM	VB
XWBQWT	JJT
FIKWRIM	NN
EDWIWT	NN
SLWWDWR	NNP
XJP	VB
ENPIM	NN
MLEIJWT	VB
KMIHT	NNT
FMALNI	JJ
ICWAN	NN
EKWAIM	NN
TPQIDIW	NN
PINNSI	JJ
AQZWJIT	JJ
MLMD	VB
LNER	VB
GWSS	JJ
EKBRIM	NN
HFBEH	NN
AWMBRJW	NNP
HPLT	NNT
MFKN	NN
LSGL	VB
HPLW	VB
MBIF	JJ
ALMWNIWT	NN
1.2.19	CD
MBIE	VB
HWXLH	VB
4	CD
HWXLJ	VB
MBIA	VB
MBIN	IN
TPQIDIM	NN
PNIIH	NN
HKRZT	NNT
APQWJ	NNP
BKIRI	NNT
BKIRH	JJ
HRCLIH	NNP
APLIM	JJ
ITXZQW	VB
PWLIJIWT	JJ
HTBJAWIWT	NN
APLIH	NN
HTNXLWIWT	NN
ASKWLWT	NN
AGRWNWM	NN
MSTERIM	VB
RCXNIT	JJ
GWLFWT	VB
HKRZH	NN
GWR	NNP
MXIRM	NN
MXIRI	NNT
MXIRH	NN
NCBE	VB
SWDI	JJ
GDWLH	JJ
IRIBIW	NN
NFIMH	NN
IRIBIM	NN
TXTWM	VB
TXTWN	JJ
CWRTH	NN
MXIRW	NN
SIJWACIWT	NN
MAWRGNIM	JJ
NCBR	VB
BICWEW	NN
I.K.	NNP
LWXMT	NN
4891	CD
JWBIH	NNP
JWBIM	JJ
HCHRTI	JJ
HTNXLWT	NN
TAWM	NN
MDQDQWT	VB
BNGAL	NNP
RDIAJWRI	NNT
EFIR	JJ
MMDI	JJ
NXFQ	JJ
SXWRH	NN
AF	NN
LHTNTQ	VB
NXFD	VB
AWRCQI	NNP
IWEBR	VB
EINWIIM	NN
NXFB	VB
HWWIH	NN
DIXWI	NN
IEWDW	NN
EWZRT	NN
EWZRW	NN
BRLIN	NNP
KNIET	NNT
RBDIM	NNP
TMWNWT	NN
WWALIWM	NNP
DBRIHM	NN
MFPXTH	NN
HFLKWTIHN	NN
APLH	NN
MFPXTW	NN
GRWSHDRN	NNP
FPIRA	NNP
PRDWQSLI	JJ
SWXRIM	NN
HIFRDWTM	NN
RIBWNWTW	NN
ICRIM	NN
GWPNIT	JJ
MTIIXDIM	VB
NRXB	JJ
HFWWAT	NNT
HWRAT	NNT
AP	MOD
SNDWWIC	NNP
HTNDBWT	NN
KDWRGLN	NN
NKLLT	VB
8891	CD
GII.	NNP
MGBLH	NN
HWRAH	NN
XRARDW	NNP
XKIRH	NN
NITN	VB
RCWIH	VB
HFLIMW	VB
QWBRIM	VB
LHIWT	VB
MTPWRRT	VB
QFIFIM	NN
ZWLT	NN
MTAHB	VB
LIZWM	VB
LWBFI	NNT
MKLLT	NNT
FNIWT	NN
ZIHMH	VB
LWBFT	VB
AX	NN
MWZIAWN	NN
ZWLH	NNP
SKINIM	NN
ZUL	NN
MCWINT	JJ
PNLWPH	NNP
KRWK	VB
MQIIMT	VB
HBRXT	NNT
EMWQH	JJ
HCET	NNT
DQDQNI	JJ
MDPIM	NN
BLJW	VB
HCEH	NN
NFPK	VB
KRWZ	NN
MCRI	JJ
SLILT	NNT
NWHGIM	NN
EBDALLH	NNP
MLWNWT	NN
MIAMI	NNP
LRMWZ	VB
FIRIHM	NN
QARSWN	NNP
LRMWS	VB
IHWWH	AUX
JEH	VB
TEFIITIIM	JJ
LFXWQ	VB
PIRWQ	NN
BEIITI	JJ
BEIITH	NN
PIRWT	NN
BEIITM	NN
BWRIS	NNP
LHTIICB	VB
RMBUM	NNP
JIIMS	NNP
CIWRIM	NN
HTMSRWT	NN
QRWBIM	JJ
QIBLNW	VB
CIWRIT	JJ
HTBRR	VB
AWFR	NN
NAMNWIWTIW	NN
SWCIWLWGIIM	JJ
HSBRH	NN
ECBWT	NNT
ASISJNJIT	NN
IXZIQ	VB
BIJWIIM	NN
IXZIR	VB
S	NNP
LBSWP	RB
LIQJ	VB
XWP	NNT
XWQ	NN
XWL	NN
AIFAM	NNP
LIQR	NN
JISWT	NNT
XWF	NNT
XWG	NNT
XWD	NN
MNWSIM	JJ
NBHLIM	VB
XWC	NN
MENIINIM	JJ
MZMN	RB
DWQRNI	JJ
NRAW	VB
HWKNS	VB
ECRT	NN
HSRJH	NN
HWEMD	VB
NRAH	VB
NFRQH	VB
LTQWE	VB
ARGWNIIM	JJ
PXD	NN
GALWP	NNP
FIMWN	NNT
IRCH	VB
4,000	CD
IFWB	VB
QWLNWEIT	JJ
FPL	NN
FIMWF	NN
PANJWM	NNT
FPI	NNP
FPH	NN
SPWRJ	NN
MZDMNWT	JJ
FPT	NNT
IFWW	VB
MTINWT	NN
FPR	VB
NALCWT	VB
IRCW	VB
NFQPT	VB
LWBF	VB
LNSWT	VB
IFTQPW	VB
IDIEH	NN
MAXR	IN
SIMPAJI	JJ
CEDIHM	NN
TWPEH	NN
LNSWE	VB
TWPET	NNT
MWEDPIM	JJ
BRAF	RB
MJPLWT	VB
BRAD	NNP
IEBIR	VB
IWRDIM	NN
ALWPWT	NN
SPWRJAIM	NN
SAGH	NNP
SIP	NN
RCXW	VB
MXLQH	NN
DLTWT	NN
AZKWR	NN
DHWA	NNP
JWBTM	NN
HCDIQH	VB
SWTRT	VB
DHWI	JJ
SIN	NNP
RFWTW	NN
FWWI	NNT
GLAZGW	NNP
TAW	NN
MSIIET	VB
TIMWT	NN
BIWRWQRJIT	JJ
MERIK	VB
59.90	CD
0991	CD
LBNWNIZCIH	NN
DMEWT	NN
MERIB	NNP
IXWLLW	VB
TAI	NNT
LHXLIF	VB
JIB	NNT
EKWR	JJ
MMWXFB	JJ
FLXH	VB
HSKM	NN
MHGRIM	NN
MBXNM	NN
LHXLIJ	VB
IQCC	VB
FWTPW	NN
FWTPT	NN
CRIPWNIM	NN
FLXW	VB
NBLET	VB
JIQ	NN
FIXWTIW	NN
MERBIWT	JJ
SWLL	NN
SWLM	NN
0998	CD
ICATM	VB
MWKNH	VB
LSIRWGIN	RB
FERWT	NNT
GIAW	MOD
HPXTT	NNT
MJRT	NNT
RAFIT	NNT
MJRH	NN
XRIPIM	JJ
QPIJLIZM	NN
HXMCNW	VB
SQNDINWWI	JJ
SI.	NNP
QWMWNISJI	JJ
ENPIIM	JJ
HELTH	VB
HTECMW	VB
HPSQWT	NN
FLP	VB
NDIBH	JJ
AWNNWT	NN
19	CD
3,512	CD
MFPJ	NN
SJLMK	NNP
MIGRF	NN
PIZH	NNP
BHIRWT	NN
MKXIFIM	VB
KBF	VB
QBRWT	NN
KBD	JJ
SBAI	JJ
MEWNIIN	VB
HMXFT	NNT
FRIRWT	NN
PIRWFIM	NN
KBR	RB
XIWBIWT	JJ
DINGIAW	NNP
MEWZIM	NN
QWNCRN	NN
5000	CD
MKINH	VB
NFA	VB
TRCW	VB
LIMWR	NNP
K	IN
MHLK	NN
NFI	NNT
QRMRB	NNP
BLM	NN
MGIEIM	VB
BLI	IN
NFR	NNP
NFQ	NN
TRCH	VB
JIBH	NN
BLA	IN
HTQFRWIWT	NN
AHBTW	NN
TFWMT	NNT
LHSIG	VB
905	CD
TRNGWL	NNT
PRIMAQWB	NNP
AWZLT	NNT
FIFIM	CD
FWPJIM	NN
LHSIQ	VB
LHSIR	VB
AZRXI	NNT
IWSH	NNP
TLIIH	NN
DMWQRJIZCIH	NN
DRFW	VB
MFMEW	NN
MWRJWRIWM	NN
TLWTN	NN
DIN	NN
PRIFTW	NN
MQSIMWM	NN
PRIFTM	NN
DRFH	NN
DIH	MOD
NIAWTW	VB
NDWN	NN
HSBRTI	VB
RQMH	NN
XQIRTW	NN
ZENIN	NNP
IITN	VB
MXFIBIM	VB
LEWLMIM	RB
XQIRTM	NN
RQMT	NNT
RQMW	VB
MAWKZBIM	JJ
IWPIEW	VB
PSQI	NNT
BWAW	NN
LJPL	VB
LTT	VB
FMW	NN
RKILWT	NN
FMN	NN
FMM	NN
FMJ	VB
FMH	NN
FMF	NN
CLSI	NNP
FJRWT	NN
FME	VB
BWAN	NN
RFIMWT	NNT
BWAM	NN
TZMWN	NN
IWPQD	VB
MAWKZB	VB
MWSLMIM	NN
DRKK	NN
TQWPH	NN
MWJIB	NN
TQWPT	NNT
DRKI	NNT
MSXRIT	JJ
BIJLW	VB
TARIM	NN
BMRWKZ	RB
TARIK	NN
JWJLIJRIWT	JJ
MWSLMIT	JJ
LFMWR	VB
TMWHH	JJ
MQWBLT	JJ
PIIGINS	NNP
MFWWH	VB
LHARIK	VB
HQNTH	VB
LIFUJ	NN
TIMHWN	NN
AWMRW	VB
AWMRT	VB
KHNH	RB
PJNJ	NN
PRWZH	NN
MFWBCT	VB
FKNIM	NN
HTLMDH	VB
TKNNTM	VB
NSPGW	VB
EIRNI	JJ
ADIFWT	NN
MQPID	VB
IBFH	JJ
NWDET	JJ
XWAN	NNP
LBWFH	JJ
IBFT	NN
EIRNW	NN
IEILWTW	NN
IWBL	NNP
HRCXW	NN
ETIDIIM	JJ
LHRXIQ	VB
MJRTN	NN
JQSIT	JJ
JQSIW	NN
FBBIT	NN
LWXCIM	VB
JQSIM	NN
KIMIH	NN
CWBR	VB
QPLN	NNP
AINJLQJWALIT	JJ
CPWIIM	VB
BQIAIH	NN
IXWDIT	JJ
LHTBWNN	VB
NIKR	JJ
MKNIQH	NN
LEFWT	VB
JNIS	NN
AINJLQJWALIM	NN
HNDSAIM	NN
MRXQIM	NN
SWBSIDIH	NN
LKWDH	JJ
ECMIT	JJ
HLPRJ	NNP
FKNWT	NN
PSJWRLI	JJ
XWNIM	JJ
MGIRWT	NN
ECMIM	NN
24	CD
25	CD
26	CD
27	CD
20	CD
21	CD
22	CD
KAMWR	RB
MWQLD	VB
29	CD
JRMP	NN
SIETW	NN
NQFR	VB
CKWB	NNP
PRWPWRCIH	NN
PWJNCIAL	NN
TXILTH	NN
PWMBIWT	JJ
FIPRW	VB
FIIKWT	NN
HTARGNW	VB
MHSS	VB
MBXINIM	VB
KDWRSLN	NN
PWLXN	NN
HNXIH	NN
HTARGNH	VB
PWLIWWINIL	NN
GRWSBWRD	NNP
LHGMIF	VB
HTRIEW	VB
MEQB	NN
DABL	NNP
HFTTPWT	NN
EBRIIN	NN
KDWRMIM	NN
MGWWNIM	JJ
ICLIX	VB
MBWJLIM	JJ
AILIH	NNP
MIWFNWT	JJ
MNCX	NN
REIWN	NN
PRXH	VB
HSBIR	VB
MXMWD	NNP
NKBDIM	JJ
MQRIN	VB
GWERT	VB
LXDWR	VB
XLL	NN
MWRALI	JJ
PIISL	NNP
XLH	VB
QAWNJI	NNP
XLF	JJ
XIIHM	NN
XLD	NNP
MQRIB	VB
XLB	NN
MWDBQWT	JJ
MPWRJIM	JJ
XWFNIT	JJ
MAFIMIM	VB
XLW	VB
MQRIT	JJ
LTMID	RB
APSWTW	NN
XLQ	NN
XLP	VB
SIKWNI	NNT
PRWSPR	NNP
NEFIT	VB
LNCX	VB
BDIEBD	RB
NPFWTIHM	NN
NEFIM	VB
FERWRIIH	NN
HFQIH	NN
1.73	CD
SMNJI	JJ
MWEMDI	NNT
QBCN	NN
RMLH	NNP
MAWFPZIM	VB
LNCL	VB
EM	IN
HXZIQ	VB
HXZIR	VB
ED	IN
PINLND	NNP
EC	NN
HWDEWTIW	NN
BIUL	JJ
RWXBH	NN
AXRWNIM	JJ
EZ	JJ
IBGWD	VB
ET	NN
LBNWNI	JJ
HTXZQ	VB
411	CD
NASR	VB
AMIL	NNP
NWTN	VB
XLIPI	JJ
AMID	NNP
RIGLH	VB
EZRTM	NN
EZRTN	NN
LEKB	VB
KIHNTI	VB
HWKXFW	VB
MFBFWT	VB
NWTQ	VB
MXILH	NN
AMIS	NNP
NWTR	VB
LFKB	VB
FAPTNIT	JJ
MRKZIWTW	NN
GIRWFM	NN
RDWMH	JJ
TPFW	VB
LHWWT	VB
MILWWQI	NNP
LMHDRIN	MOD
AQJIWWIWT	NN
SIAWL	NNP
DWAR	NN
MKWT	NN
GNBW	VB
LXLC	VB
180	CD
MKWN	NNT
AIMH	NN
HWENFW	VB
MWBNT	JJ
MPZRI	NNT
ARWJIWT	JJ
LXLQ	VB
GPRI	NNP
XI	VB
XN	NN
HWLND	NNP
XM	JJ
SNIGWRW	NN
MWCRIW	NN
XPIM	NN
XF	VB
XG	NN
XD	MOD
IFIBWT	NN
NWSXH	NN
MWCRIM	NN
HPNR	NNP
XWQIW	NN
XWQIT	JJ
PILIPS	NNP
HBWQR	RB
IAKJWT	NN
XWNWT	JJ
HQCNH	NN
MTWNIM	JJ
XIPAIM	NN
HJIP	VB
HSTIIGH	VB
DMIWNI	JJ
DMIWNH	NN
IWBJX	VB
PWRMING	NNP
MWXWT	NN
BHLH	NN
FIKWN	NN
EUM	NN
NEMWD	VB
MSWPQ	VB
SMIRH	NNP
FGRH	NN
MFPXH	NN
JWEN	VB
GRPWJQ	NN
MFPXT	NNT
NKSIM	NN
APRIQH	NNP
NTBET	NN
FGRT	NNT
SKNT	NNT
EUI	IN
FWHIM	VB
LBBIT	JJ
MSWPI	NNT
LEZWR	VB
IKWLWT	VB
KRIS	NNP
KTLIW	NN
CLWLH	JJ
4591	CD
ECRTI	VB
SWRQ	NNP
NXFPT	VB
LHIFAR	VB
LEZWB	VB
SWRR	JJ
RPI	NNP
TTGFM	VB
IWKNS	VB
FPXT	NNT
LPXWT	MOD
RIWZI	NNP
IWMRNWT	NN
LIIEL	VB
XMQW	VB
TQBLW	VB
EDIPWIWT	NN
HLWK	NNT
HXL	VB
MTKWNT	NN
MPRNS	NN
QBWCTI	JJ
HFERH	NN
ITKNSW	VB
FIBX	VB
ELILH	NN
LWMR	VB
HQLWT	NN
LMXWQ	VB
APLIIT	NNT
MCIEH	VB
TPNIT	NN
LWMD	VB
IFRALI	JJ
DWDAIM	NN
KFIRH	JJ
LHSBIR	VB
MRWBI	JJT
MRWBH	JJ
MSWKNIM	JJ
NWDEH	VB
AILWLA	IN
BRIAWTI	JJ
SGWL	NN
SNIP	NN
SGWR	JJ
MQCWEIT	JJ
HWDIE	VB
HRWF	NNP
JPXH	VB
NJIIH	NN
NDXW	VB
NAWMI	NNT
MWPRKT	JJ
EMMIT	JJ
IWM	NNT
211	CD
EUP	IN
IWCIA	VB
MKRZIM	NN
BDQNW	VB
RCWPIM	JJ
8	CD
HFTRBB	VB
NIDWN	VB
FXITWT	NN
MDWBR	VB
FBTWT	NN
PERIM	NN
MWFMCIM	VB
AWBRWN	NNP
IMCA	VB
IFUE	NNP
BLIMT	NNT
LHQJIN	VB
HCGH	NN
QBLWT	NNT
HJBIE	VB
HCGT	NNT
MLWKH	NN
AMRIQH	NNP
LLDT	VB
MCJIINIM	NN
IRAW	VB
PLIFH	NN
LHISPG	VB
HCEWT	NNT
MRGFIM	VB
TTQWP	VB
HPIQH	VB
HTPRC	VB
XWPFTM	NN
MWXLJT	JJ
BIILIN	NNP
CIRIM	NN
NRXBIM	JJ
BRZILI	NNP
KIWWNH	VB
PIIBWRIJIT	JJ
QIBWC	NN
900,000	CD
MHMR	VB
SKR	NN
RXBT	NNT
MJPL	VB
HRAW	VB
MWDIEINI	JJ
SIPWQ	NN
SIPWR	NN
XRDI	JJ
RXBH	NN
RXBI	NNT
HWPETW	NN
SIPWX	NN
HGIFW	VB
SIWMW	NN
161351	CD
MFA	NN
MFB	NNT
CBIWN	NN
TZKH	VB
MFH	NNP
RWBN	PRP
RWBM	PRP
MFK	NNT
SGWLH	JJ
HWGIM	VB
MCWPH	JJT
RWBH	NN
MFQ	NN
PSIKIAJRIWT	JJ
HISS	VB
MEBIRH	VB
IWRI	NNP
HRQIEW	VB
TCA	VB
PNIIT	NNT
AISLAM	NNP
ETIDIM	VB
XWBT	NNT
KISWI	NNT
MXQ	VB
SWBL	VB
XWBH	NN
DDI	NNP
MNGNWN	NN
MABDIM	VB
ETIDIT	JJ
TIAWLWGIM	NN
IXWF	VB
TWFIIH	NN
MERBIIM	JJ
JRIJWRIALI	JJ
JILPNW	VB
NRCX	VB
KLKLIWT	JJ
DWRFI	NNT
HISJRIH	NN
13,095	CD
IPGMW	VB
HXKIRH	VB
LXIWT	VB
EBRTW	NN
MWKSP	JJ
TXIIB	VB
SRIQWT	NN
MFIMWT	NN
MTKNNIM	VB
DWRFT	VB
SPILBRG	NNP
ICIRWT	NNT
TXIIH	NN
EWLH	NN
EWLI	NNT
MRDKI	NNP
EWLM	NN
RPSWDH	NN
MXWLQT	VB
HFTMFW	VB
MGWBFT	JJ
RCIWNLISJ	NN
FLIJH	NN
FNIHM	PRP
BEQIPIN	RB
TMHWNI	NNT
AFTI	NN
ATGRI	NNT
NSIBWT	NN
KDI	IN
PLFTINI	JJ
KBWDW	NN
MWRAL	NN
XFBW	VB
MQRI	NNT
KBWDM	NN
MIWSRIM	JJ
XFBH	VB
ITEWRR	VB
LHKLIL	VB
AWRXN	NN
HSLJIIN	NNP
PJM	NN
IGNH	VB
MQCWEN	NN
MQCWEI	JJ
LSGT	VB
MXMMT	VB
BNBNIFTI	NNP
CQIM	NN
PRNSIS	NNP
QWBNJRI	NNP
QARIIRH	NN
CIJJ	VB
AWPIINIT	JJ
MERKT	NNT
SPRDIT	NN
NDP	VB
MQCWEW	NN
BWXRIM	NN
965	CD
NDRFIM	VB
AILWZ	NNP
XWMRI	NNT
XWMRH	NN
AFDWDI	JJ
TWPSIM	VB
MRPA	NN
XWMRT	NNT
IFWBW	VB
IWCRIM	NN
ARCW	NN
EWBDIW	NN
SPWNSRIM	NN
LAWJMN	NNP
DRWWIF	NNP
AIPFRH	VB
PLAFWB	NNP
ARWXH	NN
TIFME	VB
AIPFRW	VB
PGIETW	NN
AWNQIIH	NN
ARCM	NN
EWBDIH	NNP
ARCH	RB
ARCI	JJ
EWBDIM	NN
MWTNWT	VB
FIBWFIM	NN
BGLL	IN
MFKNTAWT	NN
IIRD	VB
DWBRWBINCQI	NNP
TRBWTIT	JJ
QWBLSQI	NNP
IXPWC	VB
RIXWQ	NNT
NTWNIM	NN
MJILH	VB
MTGBF	JJ
HRCBRG	NNP
IFLMW	VB
PISIT	JJ
FNIAWR	NNP
HFLJT	NNT
BWGR	NNT
FBEW	VB
GDRWT	NN
MBIEIM	VB
GWRG	NNP
MWXN	NN
FBEH	CD
RGLIHM	NN
14.3.89	CD
LQBL	VB
DWGMH	NN
BWRMZIM	JJ
IKHN	VB
HIINRIK	NNP
DWGMA	NN
LHCIT	VB
EBWDT	NNT
HWAIL	IN
EBWDH	NN
MQRNIM	NN
GGWT	NN
MWPRZ	JJ
KTR	NNP
NHRSW	VB
DWGMT	NNT
AWXNH	NNP
XRIG	NN
HWMWRISJ	NN
MFQIEIM	NN
XWQRIM	NN
MGMT	NNT
HEMQT	NNT
XWQRIW	NN
LHTNHG	VB
SMPDWRIH	NNP
SIBWKIM	NN
SLPSJIQ	NNP
MXLQWT	NN
HINW	AGR
QBILIM	JJ
NPQD	VB
FINNW	VB
NPTX	VB
THLIKI	NNT
IWLI	NNP
HINH	AGR
XINWKW	NN
EWTMNIT	JJ
MJAPISIT	JJ
GWRMIM	NN
PXWTWT	JJT
AXIHM	NN
SLJIQS	NNP
BLIIND	NN
MQHIIL	NNP
TQWPTW	NN
RPWRMWT	NN
PWRJLND	NNP
MRCH	NN
AMWRH	VB
XINWKM	NN
QWLWNIALISJIWT	JJ
MWQEWT	VB
XINWKI	JJ
NIMH	NN
HTBLBL	VB
GWDWNWB	NNP
KIFWRIM	NN
TQWPTH	NN
AWPRJIWWIM	JJ
KIFWRIW	NN
QANCLR	NN
AWPRJIWWIT	JJ
ABHR	NNP
PXDH	NN
NIMR	NNP
MQRIWT	NN
XLPW	VB
CNWEWT	JJ
KRMWN	NNP
QWNH	NN
MMWRMRIM	JJ
EIMWTIM	NN
MEIRH	VB
HTPZRW	VB
XLPH	VB
LHIHPK	VB
ZKIH	NN
QRICR	NNP
SERT	NNT
FRIMPS	NN
HFMIE	VB
FIKL	VB
MCIL	VB
TIMNE	VB
MXQRIM	NN
QWNI	NNT
MCIG	VB
EGWMH	JJ
MCIE	VB
IRQWNI	NNP
LHRKIB	VB
MHIRWT	NN
NECRW	VB
BIJXWN	NN
XFWPWT	VB
KDWRSLNI	NNT
SERH	NN
PLWR	NNP
XMLH	NN
LJINIT	JJ
HCMDT	NNT
TWAM	VB
LHIKFL	VB
LXLWJIN	MOD
O	NN
FARIM	NN
LHSTKN	VB
HWTIRH	VB
RIKWZIIM	JJ
BNGQWQ	NNP
TWAR	NN
RPWBLIQWT	NN
CPWIH	JJ
NERKH	VB
HPQH	NN
BNWI	VB
TIWWK	NN
ANDWQRINWLWGI	JJ
SJRIQ	NNP
NEBWD	VB
BNWX	RB
MIFWRIM	NN
MQCT	NN
QPDNWT	NN
SJRIJ	NNP
LPID	NNP
PINTH	VB
PINTI	JJ
RWZNSL	NNP
XNQ	NN
GMLH	VB
TGWBTH	NN
QARPIW	NNP
KLKLIT	JJ
MSWLSLWT	JJ
MILA	VB
MGPIIM	NN
RGEI	NNT
IWBNJWS	NNP
NQSWNH	NNP
NWSKIM	VB
XNH	NNP
IPANIT	JJ
TGWBTW	NN
IIDIF	NN
XNN	NNP
MWWTRT	VB
WWEDT	NNT
HTMWJJ	VB
KIBWI	NNT
KIBWF	NN
JJRIWT	JJ
QRIIRH	NN
LGWR	VB
PNIMI	JJ
PNIMH	MOD
ARWXWT	NN
JIL	NN
HBLJT	NNT
BQRH	NN
MMFLTIIM	JJ
CBEWNIWT	NN
FLJWN	NN
PNJWMIMH	NN
LXZWR	VB
MSWKNT	JJ
HBQEH	NN
MMLKT	NNT
NGRSH	VB
QWMWT	NN
TWSPT	NN
PWNQCIWT	NN
SINIWT	JJ
MSWRTIT	JJ
MMLKH	NN
HZDMNWIWT	NN
HDWRH	JJ
ECBNIT	JJ
MSTLQIM	VB
NWRH	VB
XIILT	NN
NWRA	JJ
MDWR	NN
AGWDT	NNT
AGWDH	NN
MWPIEWT	VB
SGIRTM	NN
FWALIM	VB
MDWE	QW
NWRW	VB
HEMIDH	VB
MFTTPI	NNT
GQIL	NNP
SMJAWT	NNT
NWRMLIWT	JJ
PEMIIM	RB
IIHNW	VB
HTKNSWT	NN
HTMWJJWTH	NN
PCEIHM	NN
ADIDS	NNP
RWMNIM	NN
ITQBLW	VB
PQWE	NNT
LKT	NN
SIBWLT	NN
GWMEH	NNP
AZRXIM	NN
JLWWIZIWNIIM	JJ
FLMWT	NN
QANIBLIM	JJ
IWQRH	NN
CIRI	NNT
IWQRN	VB
CMWDH	JJ
MISIM	NN
XIILWT	NN
NXBJ	VB
MTKWNNIM	VB
NXBL	VB
PTRWNWT	NN
TXT	IN
MTMWDDIM	NN
NICL	VB
HXLJWTIW	NN
60838430	CD
MLKWDT	NN
TCWRP	VB
MFWWQ	VB
KPLIIM	NN
PZIZIM	JJ
KPIIH	NN
NWFNH	JJ
ALPWNSW	NNP
KPIIM	NN
MTQIIMIM	VB
MNWKH	VB
TEWPH	NN
IIBWF	NN
IIBWA	NN
IIFMEW	VB
GIBWR	NN
ICJRP	VB
QMPSINWS	NNP
HTRFMTI	VB
NICIM	NN
HTGIIS	VB
PITXW	VB
ICJRK	VB
GIBWI	NN
AXZWR	VB
MNWKR	JJ
MWXIM	VB
GIBWF	NNT
BGDAD	NNP
NBWN	JJ
SQJWR	NN
LWXWT	NNT
24.90	CD
BWRMH	NNP
MSWRT	NN
MRXBI	NNT
LHPIQ	VB
FQWP	NN
ZQN	NN
FQWL	VB
TPWL	VB
DIALWGIM	NN
TQNH	NN
LHPIC	VB
HIELMW	NN
SWGW	NN
HXZRIM	NN
RJRWAQJIWWIT	JJ
5.11.90	CD
FWRFIM	NN
MTNGDIM	VB
HWKXWT	NN
XDINJWB	NNP
EFITI	VB
XTMH	VB
XWRMH	NN
ABWTI	NN
IWFLM	VB
TXQWR	NNT
HWLEJW	VB
MLWNAWT	NN
SWCIALIT	JJ
LHFWWT	VB
FWRFIW	NN
HQFR	NN
MGALWMANI	JJ
LHRFWT	VB
NFMEW	VB
MFRDI	NNT
SWDAN	NNP
NFMET	VB
WRH	NNP
MWEMDWTM	NN
MKXIF	VB
LFEBR	MOD
NFMEH	VB
LHIPJR	VB
MWSRIT	JJ
HCBIE	VB
MGN	NN
KIS	NN
CBIET	NNT
NIMWS	NN
LWXMH	NN
7.0	CD
ISIIE	VB
MQWMIT	JJ
QWLQJIWWISJIWT	JJ
MEJPH	NN
LHQH	NN
AWPJIMIWT	NN
LHQL	VB
CBIEH	NN
DRIFWTINW	NN
QBWEIM	JJ
EJIW	NN
QABRRH	NNP
PCEW	VB
JENTW	NN
IITKN	VB
MILIMJR	NN
JENTN	NN
XTMW	VB
JENTM	NN
ITPRSMW	VB
JENTH	NN
PCEH	VB
PCEI	NNT
EJIH	NNP
NDMIT	VB
SWSIIDAD	NNP
IUD	JJ
IUF	ZVL
HTRGFWTM	NN
LHFMID	VB
LHFMIC	VB
BANPILD	NNP
HXJIA	VB
LCWWT	VB
FWER	NN
HCIE	VB
MCBIEWT	VB
HCIG	VB
SWBIIJI	JJ
HCIB	VB
FWEL	NN
AGUX	NNT
RDLR	NNP
TIAJRWN	NN
8691	CD
IMFIKW	VB
BLFR	NNP
MEWRRT	VB
38	CD
REIDT	NNT
HQJIN	VB
TWPIM	NN
33	CD
32	CD
31	CD
30	CD
37	CD
36	CD
34	CD
CDNW	NN
MQBIL	VB
NMDD	VB
HDGFTI	VB
MXWIBIM	VB
IENIQ	VB
HTPLL	VB
QLASIWT	JJ
QFMIR	NNP
FXRWRM	NN
FQ	NN
FR	NNT
LFBC	VB
TLWNTM	NN
LHIWWKX	VB
ABJLH	NN
MLMDWT	VB
CIDDW	VB
SWCIALISJIT	JJ
MWLBI	NNP
BILIWNI	CDT
FB	VB
SML	NN
FD	NN
FF	CD
MGP	NN
2891	CD
GEGWEIM	NN
FL	POS
GIBALIH	NNP
QWPMN	NNP
KRKRH	NN
MDI	MOD
HIQF	NN
MFTDLIM	VB
WWLB	NNP
AQSIWMH	NN
WWLF	NNP
RCTH	VB
MWDPSIM	VB
MDE	NNT
NHDR	JJ
QJNWT	JJ
HIQP	NN
TPIFTW	NN
MDGIFIM	VB
AINJR	NNP
WWLP	NNP
QWLANWBIC	NNP
NGZR	VB
MFTWQQ	VB
PRIIM	NNP
TSKWL	NN
HTQPI	JJ
MPGINWT	NN
HSTWBB	VB
BQFWT	NN
FRWIIM	VB
MMWXZR	JJ
EBIRWT	NN
RIBEWWI	NNP
DWMARS	NNP
SWRIIM	JJ
DTIIM	JJ
ILMD	VB
ARCIT	JJ
JEN	VB
DWLQWT	VB
JEM	NN
MXWZ	NN
MTEBIM	VB
HRPIH	NN
LHRIC	VB
MICWI	NN
FWPKIN	NN
QWMIQAI	NN
840	CD
21PLIWN	ZVL
KWKBIM	NN
CBWE	JJ
NWJFIM	VB
5791	CD
ANRIQH	NNP
MXWC	IN
LHRIX	VB
MCJIIRT	VB
HPQT	NNT
EWNT	NNT
RWAIIN	VB
HPTIE	VB
MXIITN	NN
22051	CD
CRWRH	JJ
EWNF	NN
EWNG	NN
ALMWNIM	NN
FLILI	JJ
MITH	NN
ABIBI	JJ
EWTQIM	NN
PWRJSMWT	NNP
EWNH	NN
LINDAW	NNP
MSRIM	NN
KBIF	NNT
TXNTW	NN
HSGR	NN
FXCNWT	NN
NMCA	VB
MTNUSIM	NN
EIRWNIT	JJ
PSJIBL	NNT
EFIIH	NN
MFTP	VB
WIZL	NNP
AMBWLNS	NN
MWHR	NN
WIZH	NNP
TQWEIM	JJ
KFM	IN
TRWPT	NNT
ABA	NN
NZQ	NN
MFWLBT	JJ
HTLWNNW	VB
FMIRH	NN
ABI	NNP
MWNXI	NNT
EWLMIT	JJ
ABN	NN
TFALW	VB
ABR	NNT
HGM	IN
AQDMIWT	JJ
PEILIM	NN
FIEWRIM	NN
FMIRT	NNT
RXWQH	JJ
BAWAR	NNP
HWCATI	VB
PRCI	NNT
PRCH	VB
SGNI	NNT
NMSRH	VB
HFWWAH	NN
FRIRNIM	NN
NMSRW	VB
TFWAH	NN
ITQIIMW	VB
PFWJIM	JJ
HISPANI	JJ
MHWTIT	JJ
CMDIM	NN
PRCW	VB
BFWRTH	NN
FMWEWT	NN
QWSMJI	JJ
NQBEW	VB
AIDIAWLWGIWT	JJ
AWLPN	NN
FMWT	NN
KIWWNI	NNT
LWQXT	VB
PLILIWT	JJ
FKWNWT	NN
IIDRS	VB
TLWNH	NN
HDPSIM	NN
ARAL	NNP
MKPR	VB
REL	NN
THLIK	NN
HWPNH	VB
QWWINS	NNP
300,000	CD
TQBL	VB
MWNARKIH	NN
FABWRH	NNP
HNPLD	NNP
SPSL	NN
34.90	CD
MTGBFT	VB
FRRH	VB
SMKWIWTIW	NN
MSEDWT	NN
HKREH	NN
IBJIX	VB
SPINH	NN
MENIIN	JJ
MWZR	JJ
IRIEWT	NNT
MWTRT	VB
TCLWMI	NNT
AIDIALIM	NN
BIINIF	NNP
PSIKWLWGI	JJ
CINIT	JJ
MDGIFH	VB
MWDRNIWT	JJ
LPI	IN
10117	CD
BAJINIWL	NNP
TSKWLIHM	NN
EDIPWT	NN
FIER	NN
PWLJ	VB
PWLF	VB
MJWPLIM	NN
BWHDNH	NNP
BWER	JJ
HTRXFH	VB
TFLX	VB
BWEZ	NNP
PWLQ	NNP
PRJIZN	NNP
DIRWTIHM	NN
TAWWTW	NN
GIISWT	NN
HRXQH	NN
QWNGRS	NN
QRINT	NNT
PQWDH	NN
ABRDIN	NNP
NIKRT	JJ
EIMWT	NN
NIKRH	VB
MXRWZWT	NNT
PEWLWT	NNT
ICJRPW	VB
GI51	ZVL
PRWZAQ	NNP
HGBIRW	VB
HZKIR	VB
KWBD	NN
AHWD	NNP
AHWB	NN
TSTIIM	VB
MWPNH	VB
BIWRWQRJIM	NN
IWNS	NNP
CMCWMIM	NN
BIWRWQRJIH	NN
MWGNWT	JJ
NPXW	NN
IWNH	NNP
IWNI	NNP
HFTWQQTI	VB
RAWBN	NNP
QIWW	VB
TQIPWT	NN
SBRW	VB
TIRAH	VB
586	CD
IXIDH	NN
MILWWL	NNP
IWHAN	NNP
581	CD
NIHWLM	NN
ALWPIM	NN
IELH	VB
MRAH	NN
HTIIQRW	VB
MRAF	RB
FBETIIM	MOD
HTNHLW	VB
IXIDT	NNT
5405	CD
KWWNTH	NN
IFXQW	VB
GLED	NNP
MWXFIT	JJ
DMWT	NN
FINWIIM	NN
AMSLM	NNP
MRQJIM	NN
ABNR	NNP
ITXRW	VB
HWRXQ	VB
HJPH	NN
PIFWJ	NNT
FIKNE	VB
BWLWNIH	NNP
KLBIHM	NN
LHNFIM	VB
MCWRPIM	VB
2,000	CD
HKRH	NN
XDIFH	JJ
2,004	CD
HKRT	NNT
LZHWT	VB
MTNKLIM	VB
ILMDW	VB
IRWFLMI	JJ
FNWI	JJ
SNDLR	NN
ABSWRDI	JJ
HFKLH	NN
EWLBIM	JJ
BWLGRIH	NNP
BQFWTIHM	NN
MFJRT	NNT
QRIAT	NNT
SWBLT	VB
QRINH	NN
QRIAH	NN
HQDMT	NNT
MFJRH	NN
HTAMT	NNT
PAFB	NNP
MZKIRWT	NNT
MCDDIM	VB
MWQPA	JJ
PNAWMJIQH	NN
8591	CD
LWJWN	NNP
FKWNH	NN
FNWA	JJ
QWLM	NN
XBRT	NNT
PGIEH	NN
TWCR	NN
5891	CD
PGIET	NNT
NISTH	VB
WRDR	NNP
RBWTA	NN
MSPD	NN
MLAKWTIIM	JJ
IXLWP	VB
FKWNT	NNT
MPEILT	NNT
AIDIAWLWGIT	JJ
IGIEW	VB
MIDWT	NN
MJRWT	NN
PXDTI	VB
MKHNIM	VB
NSXRWT	VB
BMAIM	NN
ENPI	NNT
RBBWT	CDT
BNIN	NN
AWRLANDW	NNP
PJWR	VB
HTMQDW	VB
MHLWMT	NNT
FIJTH	NN
FIJTI	JJ
IBWANIM	NN
AWLMW	NN
NAWN	NN
MERBH	RB
NIIRWT	NN
NAWT	NNT
NAWR	NNP
BLJMN	NNP
LHTRKZ	VB
MHLWMH	NN
HFTIIKWT	NN
ERNWT	NN
MFXRRIM	VB
TTAMT	VB
MECRIM	NN
TRXIQ	VB
IHWDIIM	JJ
HTNHL	VB
MQHIL	JJT
IHWDIIH	JJ
79.90	CD
LSMN	VB
ANWFIT	JJ
9891	CD
ITWQN	VB
TRXIB	VB
AINJRS	NN
TRXIF	NN
KWNNWIWT	NN
JMWN	VB
MWDAGIM	JJ
ABWQSIS	NNP
ZIQWQ	NN
MRKZIWT	JJ
BJIXWT	NN
XIWNIWT	NN
HRWWIXW	VB
HTXFB	VB
JRIQ	NNP
BNIIH	NN
LQWXWT	NN
JRIZ	NN
SISMAWTIW	NN
ITBE	VB
SWBBIM	NN
HXMCH	NN
PWLIJIQH	NN
NKLLH	VB
NWPX	VB
TGWWE	VB
1,000	CD
PSWQIM	NN
FLWFIM	CD
NWPF	NN
1,008	CD
BRZL	NN
TWKNH	NN
NWPL	VB
ICIRH	NN
BRZI	NNT
PWRIWT	NN
SNJRW	NN
MFQIEH	VB
HRXQ	RB
QWRPW	NNP
LHACIL	VB
HMWMH	JJ
MTBIIF	VB
IFPIE	VB
TQWPWTIHM	NN
FWIIC	NNP
HISJWRIIM	JJ
MKWNITW	NN
ANDRW	NNP
AMPIRIT	JJ
MWBJX	JJ
KMAL	NNP
NWKXIM	NN
FQSPIR	NNP
CLLIM	NN
AMWNTH	NN
NWKXIT	JJ
MEPEPIM	VB
TZH	NN
PIGWEI	NNT
XDR	NN
BLBWL	NN
IQXW	VB
TMHW	VB
IIBXRW	VB
MBCE	NN
TMHR	VB
NMWKH	JJ
RILQH	NNP
HSPIQW	VB
HTBRG	VB
TAPFR	VB
QWNDSI	JJ
HSPIQH	VB
PRISH	NN
NGEW	VB
MAGIQ	NNP
BTIHM	NN
IXLW	VB
QWMDIH	NN
AMRIQNIT	JJ
NIFWAI	NNT
LNXWL	VB
FMRNWT	NN
131	CD
HKNSH	NN
LQPX	VB
AMWTIHM	NN
HKNST	NNT
QANARI	NNP
2791	CD
BIDWRIWT	JJ
BIBI	NNP
SRZW	NNP
SMINR	NN
LBCR	VB
MFEFEWT	JJ
FIFI	NNP
NPLJH	VB
AFMH	JJ
FWWRDNADZH	NNP
DQWT	NN
LBCE	VB
IDRFW	VB
FWPJT	NN
HWZLWT	NN
GMIFIM	JJ
MWUP	NN
BNQAWT	NN
AFMX	VB
HTEMLWT	NN
BWRSH	NN
RATH	VB
EFIRI	JJ
PWLNSQI	NNP
MCWJJIM	VB
LHFQIE	VB
LBLWE	VB
FNTIT	JJ
TQLH	NN
HFTTPW	VB
KRMI	NNP
LHFQIP	VB
KRML	NNP
HWLNDIIM	JJ
HJEIM	VB
TWARI	NNT
BWQRFJ	NNP
HTNGDWTM	NN
BIDI	IN
ERWC	NN
NIDXIM	JJ
AIIM	NN
HKNSWT	NN
ERWK	VB
HENIQ	VB
GNFR	NNP
MKST	NNT
AFLIWT	NN
RWBRJW	NNP
IIDRFW	VB
PIQWDW	NN
HQFIB	VB
RWBRJS	NNP
DISQWJQIM	NN
PIRWJ	NNT
PLFTIN	NNP
LZRZ	VB
HTNGDWTW	NN
LASWP	VB
AWPIH	NN
SMNKUL	NNT
IWRFW	VB
TKFIJ	NN
AWPIR	NNP
AWPIW	NN
XIZWQH	NN
MABQ	NN
PNTH	VB
AZI	RB
MTNH	NN
CMRT	NN
RFIWNWT	NN
AWRIAL	NNP
CPWNH	NN
XTWNWT	NN
AWPIINIIM	JJ
PRWSWT	NN
GBBH	NN
38.27	CD
MTMQDT	VB
XIZWQW	NN
LARWB	VB
NGRMH	VB
DXWPIM	JJ
LGIJIMCIH	NN
QRAH	VB
SGIRH	NN
BLWWIW	NNP
HWFLM	VB
SGIRT	NNT
TTAPFR	VB
SJRWISQI	NNP
QRAW	VB
NBXR	VB
KAILW	IN
ALMLIX	NNP
XIQH	VB
ITPTX	VB
FKBWT	NN
NTQE	VB
EZRA	NNP
ZWWIT	NN
NTQL	VB
LHSDIR	VB
MFWNWT	JJ
461	CD
EZRN	NNP
HITR	NN
SMINRIM	NN
MTRXFT	VB
EZRT	NNT
MZHIRH	VB
IQR	JJ
NXNK	VB
ITWSPW	VB
MGWG	NNP
NITNH	VB
LSIIE	VB
RJJ	NN
DXIPWT	NN
BIJWI	NN
LRAWT	VB
BIJWN	NNP
BIJWL	NNT
MEWRPL	JJ
XFMLIT	JJ
MDWIQWT	JJ
NITNW	VB
NITNT	VB
BIJWX	NN
HKXIF	VB
QWNCRJIM	NN
HTELH	VB
GRWZLM	NNP
MXQH	VB
ICRH	VB
JARAN	NNP
EFTWNWTIW	NN
MDAIG	VB
MXQR	NN
MRGIE	VB
MCWQTN	NN
MFWRIINT	JJ
MCWQTM	NN
NEWRI	NN
ICRN	NN
LFKNE	VB
TWTXNIM	NN
AFDWD	NNP
HXLJI	JJ
RWFM	NN
MQCWEIIM	JJ
XWB	NN
TWFBIH	NN
AIDIALISJIM	JJ
NEFH	VB
GAQ	NNP
TWFBIM	NN
MMFLTIT	JJ
GAN	NN
NEFW	VB
MWPIEIM	VB
MWEDIM	NN
GAH	JJ
KFLWNWT	NN
RWCWT	VB
LHMJIR	VB
GAD	NNP
HIWT	IN
PIGWEIM	NN
TRMIT	NN
HIWW	AUX
FTIHN	PRP
PWTXT	VB
ISTIIM	VB
MCWQWT	NN
XFIBWTH	NN
MSPQT	JJ
MWPNM	JJ
HFART	NNT
JKNIQWT	NN
ZKIITW	NN
AML	NNP
MXWFLWT	JJ
IWTNW	VB
NECR	VB
027	CD
HSRJT	NNT
IISDW	VB
GNWAH	NNP
LFGR	VB
021	CD
MMWCET	JJ
QLJWT	NNT
MWDIM	VB
IBZBZ	VB
GAWWH	NN
ETQ	NN
IQIRIHN	NN
NZEQW	VB
FIXWTIH	NN
AZLM	NNP
MBWQFIM	NN
REIWNWT	NN
TQIPH	NN
QII	NNP
TNWRIM	NN
LHTPFR	VB
HZMNWT	NN
HAGR	NNP
QIC	NN
KHW	VB
KHH	JJ
NFART	VB
KHN	NNP
AMRTI	VB
280	CD
MFJRTIT	JJ
NZRQH	VB
HTHDRW	VB
QIR	NN
NXT	NN
HSTKMW	VB
NTBEIM	NN
BAJRWWRT	NNP
ANRGIH	NN
MFRDIHM	NN
PQWDWT	NN
GINWNI	NNT
TXIH	NNP
DRBWN	NN
LFQWD	VB
RWLJH	NN
NXL	VB
NXH	VB
MRIEIM	VB
QWNPDRCIH	NN
CINI	JJ
RWCXIM	NN
PINWQ	NN
MEFH	NN
MEFI	NNT
XICWNI	JJ
HIRCW	VB
ZIMND	NNP
LHIELM	VB
SINMJQ	NN
RIKZ	VB
NITWXI	NNT
AFMTM	NN
DIMWI	NN
ISMNW	VB
AMHWT	NN
MQBLWT	VB
KTBW	NN
INWHLW	VB
KTBT	VB
TIFAR	VB
AIMTH	VB
13.00	CD
MBXNH	NN
ITMQD	VB
ARBLI	NNP
SWLIDARIWT	NN
AIMTW	NN
QPDNI	JJ
FIBA	NNP
KTBI	NNT
KTBH	NN
QSJWT	NN
SIKWM	NN
IZWMH	JJ
ITKNS	VB
PDRLIT	JJ
BWXNIM	VB
AWJWNWMIT	JJ
MENIQ	VB
MXWDF	JJ
KINH	VB
MXWDD	JJ
KINW	VB
HTENGTI	VB
MPWZR	JJ
SPQN	JJ
KINS	VB
DRWMIT	JJ
RMWN	NNP
NBEJ	VB
NBEH	VB
WWIZWALIIM	JJ
TISGR	VB
BELH	NN
NIQWSIH	NNP
EWL	NNT
HTQIM	VB
XIFWQIM	NN
51P6ARBEIM	ZVL
EWD	MOD
DMWQRJI	JJ
MEWNWT	NNT
MEWRERT	JJ
MEWDDIM	VB
DWMIHN	NN
HMLICH	VB
EWR	NN
FPJ	VB
EPUI	IN
MGRFIM	NN
LFAWB	VB
AWQJBIW	NNP
SMLIM	NN
FBIJ	NN
IKWLH	VB
IKLW	VB
AIPSWWIC	NNP
GMCI	NNP
PLAJW	NNP
BWDDH	JJ
LFAWL	VB
MWSWRGSQI	NNP
IKLH	VB
SMLIW	NN
SMLIT	JJ
PWNH	VB
HTIICB	VB
HGBILW	VB
LIBRLIM	NN
QRLH	NNP
MPWRFT	JJ
QJMANDW	NNP
AXWZH	NN
486	CD
LIBRLIT	JJ
BLGRAD	NNP
MTAKSNIM	VB
709	CD
1630	CD
LENWT	VB
SBTI	NN
1985	CD
AIFTW	NN
NKWNWT	NN
209,000	CD
HTMWDDW	VB
1988	CD
SIET	NNT
LENWD	VB
SIEH	NN
EIRIWT	NN
AGWDLIHM	NN
HTQPWT	NN
BGRWT	NN
AWRTWDWQSI	JJ
SWEDIM	NN
AIJLQI	JJ
IBQFW	VB
CWDQ	VB
LHBIE	VB
LHBIA	VB
LHBIN	VB
GWRST	VB
LHBIJ	VB
LNDAW	NNP
TAWZKR	VB
ABLM	NN
MWNXIM	NN
CWINH	VB
HFLMT	NNT
JWRQIIH	JJ
88	CD
JWRQIIM	JJ
LFXQ	VB
MBLIM	VB
DIILIM	NN
ANGLMN	NNP
HTBDXWT	NN
HSKMH	NN
MDGM	NN
PARQIM	NN
ALIBI	NNP
CRKIW	NN
MNFNGLDBAK	NNP
NANXIM	VB
SKWM	NN
PLAGIAJ	NN
HAMINW	VB
CBEWNIT	JJ
IHWFPJ	NNP
MAMCIM	NN
ZHB	NN
MSDIR	VB
HIID	NNP
FMXTM	NN
DIWWXIM	NN
ZHH	JJ
NFARH	VB
DIKPIN	NN
MARGNT	VB
LRGL	IN
46	CD
47	CD
44	CD
45	CD
42	CD
43	CD
DIALWG	NN
41	CD
LMEN	IN
HSDRIM	NN
PRNQPWRJ	NNP
LMEJ	IN
84	CD
NQLE	VB
MIWED	VB
DNDIQ	NNP
85	CD
TWHW	NN
SPIXT	NNT
AWKSPWRD	NNP
HTBSSW	VB
SJJWJWRI	JJ
520500	CD
XLQIT	JJ
MBJAT	VB
MHDQIM	VB
AISLMIM	JJ
AISJNBWL	NNP
XLQIM	NN
EFIRWT	JJ
GDWDIM	NN
RWBINSWN	NNP
QWNPWRMISJI	JJ
ZRQWRIM	NN
MTKNNT	NNT
MQGI	NNP
QWRAIM	NN
LHTEMT	VB
XRWZIM	NN
MNEW	VB
NIMNI	NNP
EITWNW	NN
QFIXWIWT	NN
HIQLJWT	NN
GILWII	NNT
EWDPIM	NN
DRMJIT	JJ
MNEH	VB
NWGEIM	VB
NILSN	NNP
IWDET	VB
XIIBT	VB
RGIL	JJ
MCRIT	JJ
MMWNIM	NN
MDINIIM	JJ
ARCIIM	JJ
LHTRIE	VB
XBR	NN
XBL	RB
CEIRINW	NN
AWBSSIWWIT	JJ
XBJ	VB
LHTRIS	VB
QWNJRAS	NNP
HDWQH	JJ
JLWWIZIWNI	JJ
NCIGW	NN
JLPWN	NN
MGNH	VB
BRIWNIM	NN
BQBWQIM	NN
PRSJRWIQH	NNP
MFTKR	VB
BIKRW	VB
MZRX	NN
341	CD
HTRGLW	VB
G.	NNP
EMITWTIH	NN
NCIGH	NN
NCIGI	NNT
GW	NNP
PRSMH	VB
RDWD	JJ
BAIWDIH	NNP
HTBWNNH	VB
MCANW	VB
GZ	NN
IREILW	VB
GG	NN
HGINWT	NN
GD	NNP
GB	NN
AMZLG	NNP
HTBWNNW	VB
AFKWL	NNP
GN	NN
GM	MOD
GL	NN
MFTDLT	VB
AZEQT	NNT
MEDIPIM	VB
LIQWII	NNT
MEBDT	VB
MWARKT	JJ
SLJIQ	NNP
TFMWR	VB
HIMWRI	NNT
NCXWN	NN
TWPRT	VB
MEBDH	NN
AMCE	NNT
AZEQH	NN
TGBWR	NN
FWAPIM	VB
TIKTB	VB
LAXWR	MOD
HTIIECWT	NN
NRFMT	VB
NRFMW	VB
JWBAS	NNP
XFWBIM	JJ
MECBI	NNT
KHNISJIWT	JJ
HTPIISWT	NN
LHRGIE	VB
NXQR	VB
ANWJWNIWS	NNP
MECBT	VB
CLILH	NN
GIIMS	NNP
JIPX	VB
EIZAT	NNP
BEUM	NN
IFIGW	VB
NMNE	VB
MSXRIIM	JJ
MDBQWT	NNT
GRNDIWZIWT	JJ
EICWBH	NN
MWBHQ	JJ
FKNWE	NN
MQFQF	JJ
TTN	VB
MPLH	NN
XNWT	NN
MTELM	VB
MFPJIT	JJ
ZH	PRP
MTELH	VB
GARI	NNP
IQRWT	JJ
FQWPWT	JJ
GZBRWT	NNT
QBEH	VB
TWRNIM	NN
XWUL	NN
QBEW	VB
MAPIINT	VB
TMNE	VB
TPQWD	NNT
MAZIN	NN
HKWWNT	NNT
ZW	JJ
NFXQW	VB
DIWWXW	VB
WRDIGR	NNP
MRGILH	VB
MMFLIM	NN
QILWMJR	NN
DSJI	NNP
HZRIMW	VB
NMNI	NNP
WIKWXIM	NN
XCAI	NNT
MNWWL	JJ
BWGIN	NNP
MNWWJ	VB
HZRIMH	VB
ABRHM	NNP
MWRKBWT	JJ
MWXMD	NNP
MWDAGT	JJ
XGIGIT	JJ
BMQRH	RB
PWBIZM	NN
MECMTIT	JJ
HFTGEW	VB
QLCQIN	NNP
IDENIM	NN
AGWCNJRI	JJ
LHSTBK	VB
QWMWNISJIT	JJ
HTXILW	VB
SPARS	NNP
NXNKW	VB
IPANI	JJ
HFQIEW	VB
XWRIN	NNP
QRIJIIM	JJ
ARGNJINI	JJ
MKSIM	VB
LAWMIWTM	NN
MWDILIANI	NNP
TWSST	JJ
IINTN	VB
DBEI	NNP
DWEKWT	VB
QAMP	NNP
MDINI	JJ
MDINH	NN
RDIWS	NN
MILIARDIM	CD
HWBRR	VB
PLFTINAIIM	JJ
KPWLH	JJ
PIIRW	NNP
SXWJH	JJ
HFTAWT	NN
PCIEH	NN
HIABQWT	NN
XWZRWT	JJ
CBAIWT	JJ
BARNM	NNP
MDINT	NNT
GILMW	VB
HFTKRWT	NN
NWRWWGI	JJ
AWPRJIWWIWT	JJ
SBIRH	JJ
KLBW	NNP
HTAGDW	VB
LHZEIQ	VB
ECWMH	JJ
ADWLP	NNP
MAIIM	VB
WTIQ	JJ
099891	CD
LFTWQ	VB
MFMRT	NN
MSPQWT	VB
ZRWEWT	NN
GBLS	NNP
JENT	NNT
JENW	VB
JENH	NN
TXZITW	NN
NDBK	NN
LBBWT	NN
FWWDIH	NNP
XFBWNAIT	JJ
XWKMH	NN
NKBF	VB
QWWIN	NNP
MNHLWT	NNT
XIWT	JJ
XIC	NN
ADWQIM	JJ
FXRWRW	NN
QLANMCH	NNP
XIWK	NN
XIWN	NNP
IIB	NNP
IIL	NNP
XIWB	NN
GBIIH	NN
DIWWX	NN
NFXQ	VB
MFEMMT	JJ
RWMXIM	NN
AQRILN	NNP
FXT	NN
ELWT	NN
FXQ	NNP
NTWN	VB
FXR	NNP
ELWN	NN
ELWL	VB
PIJWRIM	NN
BLBD	MOD
ZRWT	NN
MWTIR	VB
BQFT	NNT
ELWB	NN
BQFR	IN
BNIMIN	NNP
FWAL	VB
6.6.82	CD
MILIARD	CD
FWAH	NN
LHKIN	VB
JIIPWN	NNP
FWAB	VB
XSRWNW	NN
NFLXH	VB
BNIINI	NNT
QRH	VB
LAIIF	VB
LAIIM	VB
LHKIR	VB
GIRWFIM	NN
FWAP	VB
LHXLIP	VB
MFQIP	NN
XKIM	NNP
MMCAIM	NN
WWLWNJRIT	JJ
10.3	CD
HTERB	VB
GIISNW	VB
MRKIB	NN
MUQ	NN
MRINWB	NNP
ASIPWT	NN
QRP	NNP
QING	NNP
QJLWG	NN
HWEBRW	VB
SAM	NNP
RWBCT	VB
AINNW	RB
QINI	NNP
MQCWEIWT	NN
MTNPX	VB
HFWW	VB
AINNI	RB
AINNH	RB
QINWX	NN
TPAWRNIT	NN
XZQIM	NN
RWDN	NN
TPIXH	NN
NPRDNW	VB
RFAIWT	VB
AISLAMIM	JJ
MFTQE	VB
INJF	VB
BICEH	VB
HWWH	NN
GBWRWT	NN
JNTM	NN
FWRWT	NNT
MTNKRIM	NN
SIXRRH	VB
LBXWR	VB
ALKWHWL	NN
LBXWN	VB
LHWCIA	VB
MNQRT	VB
CWRTW	NN
NXLQIM	VB
DBQ	NN
GBEWLI	NNT
DBR	NN
MWKRXH	VB
BICEW	VB
LHFAIR	VB
XLIJ	NNP
QALIARI	NNP
CKWSLWBQIH	NNP
ZKINW	VB
XLIL	NN
EWBR	VB
IQBE	VB
MTQNI	NNT
MUM	NNT
MWBHQT	JJ
NPALIM	NN
QLIM	JJ
NCBEW	VB
SIIRW	VB
SIIRT	NNT
FBIEIT	JJ
IWTIR	VB
QLIE	NN
EWBD	NN
MBWQFWT	JJ
MFXQ	NN
BADR	NNP
HPXTH	NN
ZWEBI	NNP
10.6	CD
RWWIWT	JJT
XIBWR	NN
BTWK	IN
RWMNJI	JJ
JWR	NN
BTWR	IN
87591	CDT
MAIIMWT	JJ
MFXH	NN
JIWLIM	NN
RIKWZ	NN
AFM	JJ
MWSDIIM	JJ
AFH	NN
KMIHTH	NN
NXLF	VB
AFF	NNP
PNIITH	NN
PWJNCIALI	JJ
IIPTXW	VB
MSWLSLT	JJ
ASP	NNP
MXFBH	NN
NIHWL	NNT
W	CC
TPQDM	NN
AFT	NNT
FMINI	JJ
LHTMCA	VB
AFP	NNT
AFR	REL
MNXM	NNP
HPK	AUX
CIPW	VB
MNXH	NN
QLIPH	NN
MNXF	VB
REIITW	NN
CBAI	JJ
LEIIN	VB
THLIKIM	NN
HTAKZBW	VB
MAWXDT	JJ
HWRWBIC	NNP
QLIPT	NNT
EWBRW	NN
XWBRW	VB
BTI	NNT
BTH	NN
HNHLTH	NN
AIMPRIIT	NNT
LHIDXQ	VB
LHEBIR	VB
MFTEMM	VB
IWZMIM	VB
MWPEI	NNT
CLBINSN	NNP
MLIQH	NNP
CIRWPH	NN
TPEWLIT	JJ
yyDOT	yyDOT
BWAH	NN
IWXZR	VB
NWXWT	JJ
RBIEI	NNP
MXWBR	VB
ICXQ	NNP
FLIH	NN
IDE	NN
CWXQIM	VB
LPNIM	RB
MWZLIM	JJ
HPSIDH	VB
XRIGH	NN
HTNPCW	VB
AWMNWT	NNT
LHBLIJ	VB
MEWLPIM	JJ
XWZQH	NN
IRDNIT	JJ
SPRJIZM	NN
BRSLB	NNP
LHTARGN	VB
HKRIZ	VB
IIFLX	VB
ZIQNH	NN
LHCJIID	VB
SIGLTI	VB
EUC	NNP
MWPIEH	VB
FPTIIM	NN
BBLI	NNP
GWPI	NNT
FITWQ	NN
FITWP	NNT
HEBIRH	VB
EUR	NNP
TPWCTH	NN
MFMEI	JJ
DGLIM	NN
XWWIWT	NN
QSIRR	NNP
HSTDRWTIT	JJ
SWMAW	VB
2,132	CD
AHWBIM	JJ
MTWEFWT	JJ
LFRWP	VB
SIJWNAIT	JJ
WWLIH	NNP
FBTWN	NN
FLIJIM	NN
MFMET	NN
18.6	CD
CMXIH	NN
BNWSP	IN
HWELH	VB
HBJIXH	VB
QPDN	JJ
NXZWR	VB
GFWMH	JJ
NAFMI	NNT
HBJIXW	VB
MTBGR	JJ
HCJRP	VB
RIMWNI	NNT
QISR	NNP
LXWN	VB
KWFL	JJ
ARGWNIM	NN
QWBEIM	VB
HXLIJH	VB
LXWF	VB
DRIFT	NNT
HWMWRISJI	JJ
IIPTX	VB
DRIFH	NN
QRIIRISJIT	JJ
MWPRF	VB
HXLIJW	VB
MWPRD	JJ
MWPRK	JJ
LXWT	NN
KWFR	NNT
AQMH	NN
GWRMT	VB
GWDF	NNT
HTWWDE	VB
GWDH	NNP
CWR	NNP
GWDL	NN
SWLIT	NNT
SPWR	NN
GWDW	NN
PWNDMNJLISJIWT	JJ
AWLJIMAJWM	NN
HKILH	VB
MPWTX	JJ
SWPRIM	NN
ESISIT	JJ
GWRMI	NNT
NICX	VB
LNWD	VB
QCRIM	JJ
ZWRXT	VB
HSTGLWT	NN
MSKWT	NN
GIDWLIM	NN
CMWDT	JJT
HFTQE	VB
LHTPTWT	VB
NICI	NNT
NICN	NNP
HWRTH	VB
AFQLWN	NNP
NICB	NN
ITERB	VB
HSTPQH	VB
HTPLGWT	NNT
WWIFI	NNP
ABRI	NNP
RM	NNP
JWRX	VB
MQWPXIM	VB
ENTH	VB
JWRS	NNP
MAPFRWT	VB
NNCX	VB
GIWRA	NNP
HWELTH	VB
BLMIM	NN
EMDTH	NN
HZDMNWT	NN
GMWRH	JJ
QJRQJ	NN
ECMAI	JJ
HWBHL	VB
LHFKIL	VB
NQNS	VB
MIWCR	VB
IRWDH	JJ
AWUMI	JJ
IRWFLIM	NNP
544	CD
QIRWT	NN
NGINTW	NN
HTAIM	VB
QIRWR	NN
HRMWNIH	NN
MFWXRRRIM	JJ
IWJL	VB
AXLMH	NNP
HWBIL	VB
IWJH	NN
WED	NNT
HPRIZW	VB
PTRWNW	NN
HWCATW	NN
HNXITH	VB
TWGF	VB
MQWNN	NNP
LHIKLL	VB
ZQNIM	JJ
WWTIQ	JJ
IWJR	NNP
QLWWIN	NNP
RH	MOD
SWXRI	NNT
BWGRT	NNT
KWWNTW	NN
MBWSS	VB
TMFIK	VB
LXTWM	VB
TTKWWN	VB
GDLH	NN
GRBR	NNP
MCJRP	VB
XBRI	NNT
TKWPWT	JJ
HTMXTH	VB
KWWNTI	NN
HTARGNWT	NN
FNWN	JJ
LIDI	IN
LIDH	NN
NWQFH	JJ
DQDQNWT	NN
IFQIE	VB
GRWZINIM	NN
MEWRBIM	JJ
GLIWLIN	NNP
yyCM	yyCM
WWDQH	NN
FNWT	NNT
LARGN	VB
TZWZH	NN
AIRWEIM	NN
HCEID	VB
NFB	VB
XDF	JJ
FPREM	NNP
IWCRT	VB
BNIIN	NNT
KR	NNT
XWSIIN	NNP
XDL	VB
LAWMNI	JJ
XDH	JJ
EDKWN	NNT
ACBEWT	NN
XDT	JJT
ALIMIM	JJ
IWCRI	NN
DETKM	NN
ABL	CC
BLW	NN
EQBWTIHM	NN
IRIBIHM	NN
BELIHM	NN
NWHRIM	VB
LBLWJ	VB
PDRALIIM	JJ
AGNH	NNP
EIQWL	NN
GWDLH	NN
MPTIE	JJ
LBLWM	VB
AWJWBWS	NN
BLS	NNP
LBLWT	VB
HFQETW	NN
XIZWQIM	NN
QBLNIM	NN
MTWAR	VB
DRMJIWT	JJ
MWAFMT	JJ
MEWBD	VB
GDWFH	JJ
NITWQ	NNT
MFWTPIM	JJ
NITWX	NN
HTAMCW	VB
RKFW	VB
TRGIL	NN
AMBIWWLNJIIM	JJ
ETID	NN
IAWF	NN
MJEH	JJ
NFP	NNT
MJEN	NN
DPWSI	NNT
FBXI	NNT
HRTH	NNP
KWXWTIH	NN
NXQRWT	VB
AWTR	VB
067008	CD
BEWD	IN
IAWT	NN
ETIQ	JJ
ETIR	JJT
RENNWT	NN
SJNDRJI	JJ
AWTM	DT
MSWRTI	JJ
RIMH	NN
NAMDIM	VB
XWSKT	NN
LHKNIS	VB
DRQSL	NNP
EWWLWT	NN
ABRMSQI	NNP
FIJWTIW	NN
MWKRIM	JJ
LELWT	VB
MLWA	NNT
MLWN	NN
MLWL	NNP
EITWNI	NNT
FTIQH	NN
XWWT	NNT
HFPIEW	VB
XWWH	VB
XWRFIM	VB
TCJRK	VB
TMLA	VB
QWNCPCIH	NN
GALH	NN
GALI	NNP
PIJRH	VB
NWSPT	JJ
NWSPW	VB
IWZMH	NN
HTRXB	VB
APFR	VB
PJWRIM	NN
NALCT	VB
LHDRIK	VB
KNSIM	NN
IWZMT	NNT
HWENQ	VB
IWDEIM	VB
HTXIIBWIWT	NNT
FIJT	NNT
HWPELW	VB
MIWTMIM	RB
HZKIRH	VB
TKKIM	NN
IFAIRW	VB
PWQXT	VB
NRDPT	JJ
MIMD	NN
MIMF	VB
MIPGF	NNT
HZKIRW	VB
QWMWNISJIM	NN
AFKNZIM	NN
D	NN
QRA	VB
QRB	NNT
QRE	NN
MZIMH	NN
QRI	RB
MILICIH	NN
QRN	NN
BIHUD	NN
SBWRIM	VB
DIBR	VB
BIHUX	NN
MZIMT	NNT
KBFW	VB
MWEMDIM	NN
BIHUS	NN
NTPSH	VB
MDWBRIM	JJ
NXLH	VB
LWXMI	NNT
DWID	NNP
NXLC	VB
TACR	NNP
MPNI	IN
MPNH	VB
ATGR	NN
MERIKH	VB
PSIKW	NNP
IGWRFW	VB
BMPWRF	RB
BIMWIM	NN
NXLW	VB
NXLT	NNT
SANS	NNP
MECBWT	JJ
MQNIM	VB
HNIBH	VB
PSGH	NN
MGWRIHM	NN
GIFWT	NN
HAFMH	NN
MIAWS	NN
AWPUA	NNP
ANJWLIH	NNP
AIJLQIM	JJ
HNIBW	VB
RWWQH	JJ
WWIDWIIM	NN
ARGWNI	NNT
HTKWWN	VB
IWBA	VB
QINGDWM	NNP
MSMLT	VB
MAFR	IN
ECWTIHM	NN
HTKWWC	VB
MTGWRRIM	VB
TSISH	NN
MWKFR	JJ
HTPJR	VB
MINISJRIALIT	JJ
IIERKW	VB
HFMCWT	NN
MMLKTIIM	JJ
DISQRCIH	NN
KHNISJIM	NN
HKXIFH	VB
HLIKH	NN
AIJWM	NN
MSWLPIM	VB
QWMPWZICIH	NN
PRFWT	NN
QWRSIM	NN
1,900	CD
HKXIFW	VB
MRHIBWT	JJ
LHXDIR	VB
MFWWQIM	VB
QDWMIM	NN
LQWX	NN
LFWNW	NN
HGIRH	NN
TWFBI	NNT
RXB	JJ
DWQJWRAJ	NN
IRDNW	VB
PWRMIIQH	NN
LQWM	VB
JIRWP	NN
LQWI	JJ
NSETI	VB
LHWDIE	VB
DMWIWTIW	NN
LFWNI	JJ
RIBWEIM	NN
59	CD
58	CD
55	CD
2991	CD
57	CD
56	CD
51	CD
50	CD
53	CD
52	CD
FLIF	NN
SNIGWRIHM	NN
PTWXH	JJ
54	CD
LAWMIIM	JJ
IINTNW	VB
MXMT	IN
JWRAI	NN
WRGAS	NNP
HR	NNT
HS	NNP
EQRW	VB
HEMDT	NNT
XFDWT	NN
HEMDH	NN
HN	PRP
PZIH	NNP
MSQNWTIH	NN
HM	PRP
MXMM	JJ
KIHN	VB
MXMJ	NNP
GRILH	NN
RCNW	VB
IDIEWT	NN
HWDPSW	VB
HWDIEW	VB
EQRWNWT	NN
TIBT	NNT
NISITI	VB
IWKRE	VB
THIIH	AUX
MNH	NN
EWBIH	NN
HTEWPP	VB
MNK	NN
NHNH	VB
QILW	NN
HWDIEH	VB
NJIFTW	NN
KLWLWT	VB
RWCXW	NN
IXZQALI	NNP
MNE	VB
MTMJIQH	NN
MRXQ	NN
MRXP	VB
MHWTI	JJ
AQWLWGI	JJ
TXRIP	VB
MFTTPIM	NN
SEWDI	JJ
ICWIDW	VB
IZM	VB
TLIWN	NN
MPRIDIM	VB
MRXC	NN
MRXB	NNT
HWPGNH	VB
MWTQPWT	VB
QRWBI	NNT
QRWBH	JJ
AFKNZI	NN
MHWTW	NN
JENWTIW	NN
TIQWNM	NN
PRWIQJIM	NN
HTMQDWTW	NN
MNSRWT	NNT
DWDWT	NN
MWDEIM	VB
QINMWN	NN
ILKW	VB
THSS	VB
MMWQDT	JJ
HWQM	VB
MZMIN	VB
BRWMIC	NNP
LHINTN	VB
JKNI	JJ
NZEMT	JJ
MCBRIM	NN
RIIDAAWJ	NNP
LXCIM	NN
036086	CD
NELIIM	NN
RWJCIH	NN
NWLDW	VB
QLABRIH	NNP
LHINTQ	VB
HSTBKWT	NN
NMIR	NNP
49.90	CD
EWDD	NNP
NRCXH	VB
BLAI	NN
QMP	NNP
LHTPJR	VB
QMW	VB
BAFR	IN
EWDP	NNT
QMH	VB
KWWIIT	NNP
MFEMM	JJ
AIMPRSIWNISJIWT	JJ
APWQLIPJI	JJ
WLSJN	NNP
HIFNWT	NNT
PSIKIAJRI	JJ
MWGBR	JJ
RFIMT	NNT
GML	NN
MJWWXI	NNT
XQRW	VB
MLXIM	NN
NJXNIM	JJ
MBCET	VB
MDBIQH	VB
NIGWD	NN
HPNIMW	VB
GMR	NN
ADM	NN
MWGBL	JJ
MWNWPWL	NN
RFIMH	NN
CIRP	VB
GDWL	JJ
BRZ	NN
FLBIW	NN
TIKP	RB
QFRI	NNT
QFRH	VB
GDWD	NNT
FWXRR	VB
BRQ	NNP
ALWNIM	NN
IHLWMIT	NNP
AWMDNIM	NN
HWMNIZM	NN
BRI	JJ
MCWIRWT	JJ
MEBR	IN
MWTNIT	VB
GDWT	NNP
FJXI	NNT
RWWXIT	JJ
PTIXWT	NN
MTMQD	VB
HTGFMWT	NNT
FIJH	NN
IWLIKW	VB
FIINPLD	NNP
HRXIQ	VB
LNTX	VB
HBIN	VB
ARKH	VB
FMX	RB
NGWE	VB
MSWBSD	VB
NTPRIM	VB
TBWSH	NN
PWRSMH	VB
CWRKIM	VB
ARKW	VB
PWRMLIT	JJ
PWLNIIH	JJ
LHPRID	VB
KLA	NNT
ESQ	NN
FBWEWT	NN
KLL	NN
RAWIWT	VB
KLH	NN
KLI	NNT
DXIIH	NN
LHPNWT	VB
HRIEW	VB
DXIIT	NNT
QIIZRSLAWJRN	NNP
LHWPIE	VB
LTKNN	VB
HWPKIN	NN
ETIQT	JJT
PFJWT	NN
FBWEWN	NN
FMWNIM	CD
RZUL	NNP
TEFIWT	NNT
ALWPT	NNT
MDMIE	JJ
NSIEWT	NN
HIINW	AUX
HMCIA	VB
AIWNIR	NNP
ALWPH	NN
DRKIHM	NN
MFBIE	JJT
LHEIZ	VB
NHNW	VB
IWPELW	VB
MNT	IN
MSGDIM	NN
QNIWN	NN
MKIRT	NNT
QLINIWT	JJ
LQDM	VB
MKIRH	NN
RKIFTH	NN
FWTP	NN
MIIJH	NNP
MFAIR	VB
MNW	NNP
MFAIT	NN
QIIZR	NNP
RAPIDIH	NNP
LHEID	VB
QBWCH	NN
BWAI	VB
HTERERWT	NNT
MTLWNN	VB
QDRWT	NN
MMLAIM	VB
MWPTI	JJ
PRANQIM	NN
MMWL	RB
NPRD	JJ
IRWDWT	JJ
FMA	IN
QBWCT	NNT
MEIDIM	VB
GWBH	NNT
PRLMNJ	NN
MPWRJ	JJ
RWMMH	NNP
HCHRH	NN
HKINW	VB
BLGRD	NNP
ZIHWI	NN
BIRQNAW	NNP
MWQDMWT	JJ
MPWRF	JJ
HTGBF	VB
MWRXBWT	JJ
HKINH	VB
HCHRT	NNT
TMWT	VB
MDBQT	NNT
QCRWT	JJ
LFLWX	VB
HGNT	NNT
AKLS	VB
AKLW	VB
MJWRPT	JJ
HGNH	NN
FWWIICRIIM	JJ
1969	CD
FQRH	NNP
CIPWRH	NNP
MZKRWT	NN
IWRFIHM	NN
MWRFE	NN
XCH	VB
LWXM	NN
FTWLIM	VB
MWRFI	NNT
MWRFT	NNT
AMRIQN	NNP
XTNI	NNT
KWZB	JJ
RPWAIIM	JJ
LXCN	NN
ELIZIM	JJ
MKWWNIM	VB
ISWPQW	VB
ETIQWT	NN
MWRDIM	NN
ZKAI	VB
LNSBWRI	NNP
JWPL	VB
LHFIB	VB
IRWFH	NN
LHFIG	VB
DCMBR	NNP
526	CD
521	CD
MPRNSIM	VB
TAILNDIT	JJ
LRKB	VB
JWPZ	NNP
FAWL	NNP
GRMH	VB
BWRRIM	NN
IWTR	RBR
NIHWLW	NN
FQRWQH	NNP
XDRIM	NN
CHUL	NNP
LHIKNS	VB
CWPIM	NN
NXFBWT	VB
HNXIWT	NN
TFWBWT	NN
AILK	RB
IWTM	NNP
GRMW	VB
MWBILH	NN
SIIP	NN
MZRXIT	JJ
ZKAIM	NN
HRFLIQWBIC	NNP
IHWFE	NNP
CIPIIH	NN
RWMNJIWT	JJ
XMDH	NN
NAMNIM	NN
MWSIQH	NN
CBEWNI	JJ
QWLWT	NN
ZKAIT	VB
PAZIH	NNP
JEWT	NN
IHIW	VB
XFBWN	NN
LHKBID	VB
SWNWWRW	VB
SWGIW	NN
XQIQH	NN
HTRKZNW	VB
MINSWJIM	NN
IHIH	AUX
FMFWNIM	NN
GLWNIM	NN
XWQIIM	JJ
MDRIKIM	NN
XFB	NN
DRIFWT	NNT
XFD	NN
MWXZQIM	JJ
XFF	NN
AWRWWLIANIT	JJ
QDS	NNP
LSXWP	VB
AISLM	NN
RJWRIQH	NN
XFP	VB
QISRWT	NN
CACAI	NNT
XFW	VB
MCWPIM	VB
AWMRM	NN
MKILH	VB
EFWRIM	NN
FHWA	MOD
PTXW	VB
MEWGNWT	VB
PAHD	NNP
MCAW	VB
PTXM	NN
HDLPWT	NN
JRWD	JJ
FHWT	NN
NPSID	VB
MXW	VB
HTXLH	NN
MNIET	NNT
TFPRNH	VB
LHAFIM	VB
RDAR	NN
MNIEH	NN
NKWNIM	JJ
NIHWLI	JJ
DIQN	NNT
MFQPT	VB
ENIFH	NN
RCWET	NNT
NAFMIM	NN
MKIRIM	VB
NIERW	VB
FQR	NN
SPRWT	NN
FWRRIM	VB
TRGWM	NN
SWCIALIIM	JJ
RCWEH	NN
BGDIM	NN
LLQIN	NNP
GRSWT	NN
RBEWN	NN
WWSJ	NNP
MBHIR	VB
LWMDI	NNT
NWKXWT	NNT
MPELIM	NN
IBWAW	VB
MTWQNT	JJ
1	CD
NPGFWT	VB
RLWWNJIT	JJ
MGILT	NNT
MPELIT	JJ
JRBLINQH	NNP
LSKN	VB
MITAR	NN
LHRAWT	VB
PRQIM	NN
FXWR	JJ
FXWQ	JJ
EMLW	VB
PRQIS	NNP
4500	CD
NTWNH	VB
NTWNI	NNT
CIWNIIM	JJ
DIQJIM	NN
IQRA	VB
MTLMDT	NN
MXLQIM	VB
80	CD
IQRH	VB
XWQI	NNT
HWLM	JJ
DBRIM	NN
HWLK	VB
EMLH	NN
DBRIH	NN
DBRII	NN
DBRIW	NN
XWQR	NN
HFKILW	VB
LABJX	VB
QIBWCIM	NN
FIXTW	NN
HXLFWT	NNT
XLPWN	NNP
MEBRT	NNT
IICGH	VB
BIXS	IN
FILX	VB
HJBETW	NN
MRI	NNP
DISQJIM	NN
MSTKMT	VB
QLIPWTIW	NN
IICGW	VB
FILH	NNP
WWTIQH	JJ
FILM	VB
BIXD	RB
MFAB	NN
TQIIM	VB
QPH	NN
ASWMN	NNP
MHFK	ZVL
KWKB	NN
MFAJ	NNP
QPC	VB
LHFXIT	VB
LHFXIR	VB
MFAL	NNT
ILIDIM	NN
TZKIR	VB
SRGLIM	NN
EREWR	NN
MHPKNI	JJ
MQWCRT	JJ
DWKN	NNT
MFTQPT	VB
HRT	JJT
1691	CD
HRP	NN
HRS	NN
HLIK	NN
MDLIIT	NNT
HRI	RB
HRH	JJ
MIRWN	NNP
SPRD	NNP
HRD	NNP
HRG	NNT
MIRWC	NNT
AINDIANIT	JJ
HRC	NNP
TPX	VB
AQDMAIIM	JJ
TXWMW	NN
MRWKZIM	VB
GRSAWT	NN
HWFMDW	VB
MZWHH	VB
RZRWWH	NN
QFIIM	NN
TXWMI	NNT
JQBSARN	NNP
PSIQWTIH	NN
HNPFH	NN
QCBIT	JJ
DNIAL	NNP
GRWSLM	NNP
XGABI	NNP
MXRIP	VB
MNKULI	NNT
MBRRT	VB
EIILH	NNP
TKFIJIM	NN
3.23	CD
CIBWRIIM	JJ
BFBIL	IN
NKFL	VB
ATRIM	NN
EZIQRI	NNP
LWMDWT	VB
GBEH	NN
RAIH	NN
KNWTH	NN
AMNWTIWT	JJ
MFKNEWT	JJ
MTBCEWT	VB
BMIWXD	MOD
HIMLAIH	NNP
MFNHW	NN
SIPWRH	NN
RFT	NN
ENH	VB
MWGMRT	JJ
BXRW	VB
SJAZR	NN
PRSWM	NN
ENQ	NN
ENT	NNP
TIARH	VB
LQXW	VB
ZIWWGIM	NN
RFM	VB
HXWCH	RB
PLILT	JJ
SWQRISJWB	NNP
AQDXIM	NN
BWRA	NN
SMRI	NNP
IMIM	NN
KITTI	NN
IMIN	NN
PWQD	VB
MLWQQ	JJ
BWRH	NNP
MWCNEIM	JJ
IMIW	NN
BWRR	NN
PWQS	NNP
PLILI	JJ
BWRX	VB
HPSQT	NNT
XWDFIIM	NN
IWMIT	JJ
MTPLLT	VB
AXRWT	JJ
PRJIWT	JJ
AXRWN	JJ
FIQWMM	NN
PISIWLWGI	JJ
KWWIIH	NN
IWMIN	NN
KNGD	IN
IIPGEW	VB
AIRLND	NNP
TAWRT	NNT
QTDRLH	NN
QIJL	NNP
FAIPWTIW	NN
NKWNWTH	NN
KESW	NN
QIJF	NN
BLQBWRN	NNP
SGWRH	JJ
HWZMN	VB
NKWNWTW	NN
MGZR	NN
HFTLJW	VB
MWEDWN	NN
HFKL	NN
HTEWRR	VB
ISBWL	VB
CLH	NN
MARQIM	NN
MILWLI	JJ
IMI	NNT
CLE	NN
PISIWT	JJ
AWMRIM	VB
KIFLWN	NN
AWSIP	VB
SWGIIT	NNT
ALKS	NNP
SWXR	NN
SWXP	JJ
FWALT	VB
LFAT	VB
DRKIM	NN
LIIBWBIC	NNP
KLLIT	JJ
PWRMJ	NN
SJIWWN	NNP
KLLIM	NN
NSTIIM	VB
PWANJWT	NN
WWLSJN	NNP
DIRWTIW	NN
GIHNWM	NN
MIIQL	NNP
NFQP	VB
DHIINW	MOD
HNHGWT	NN
MTQBL	VB
NGZRH	VB
HPNIITM	NN
LHIBNWT	VB
DIIRIM	NN
EWRQI	NNT
BEIJH	NN
TIIR	NN
NQMTK	NN
QWRWT	NN
PDRJIWWI	JJ
MSWIIM	JJ
IMIT	NNP
ESQIWT	JJ
MPLTW	NN
PWLNIT	JJ
MZMINIM	VB
JWLSJWI	NNP
MTRKZIM	VB
EWFH	VB
CDDIM	NN
AWUM	NNP
IWNIM	NN
AWRALI	JJ
QRICWT	NN
DRWMH	NN
IWNIT	JJ
ALMWZLINW	NNP
ICIL	VB
PWLNIM	NN
QLEW	VB
EWFR	NN
NWSIIRAT	NNP
LHWLID	VB
CMAIM	JJ
MLA	JJ
AWHDI	NNT
NFQM	NN
XRDH	NN
KMWIWT	NN
MLK	NN
MLH	NN
RWWXIWTW	NN
HCXIQ	VB
MLL	NN
LHWLIK	VB
MLR	NNP
BGNWT	IN
RAIITH	NN
ZMNI	JJ
AWHDT	JJ
MLX	NN
MBCEI	JJ
JRNR	NNP
NTLTH	VB
MWAPL	VB
CBEI	NNT
TTQBL	VB
FRWIH	VB
PWLIN	NNP
DGMIM	NN
TWWIWT	NN
ZEZWE	NN
SEIPI	NNT
RIAD	NNP
HTBJAH	VB
QIDWMM	NN
RIAL	NNP
HEDPT	NNT
CBEW	NN
BPRJ	MOD
KNSIIT	NNT
FBET	CDT
APWJRWPSWT	NN
ZNB	NN
JHWRH	JJ
JWRQIH	NNP
SNDLRWT	NN
JWRQIM	NN
MDBR	VB
XAG	NN
NBLMW	VB
ZWLIM	JJ
KNSIIH	NN
TLIWNIM	NN
AHRWN	NNP
ARIH	NNP
FMALNIM	NN
IFWBIM	NN
MDRFH	NN
LWWIIT	NNT
IEQWBI	NNP
SBIBH	NN
HPQWT	NN
MWEMDW	NN
PWRMLIIM	JJ
ADI	NNP
PZGZ	NNP
FXQNIWT	NN
KNH	JJ
ZRWE	NN
H	H
MTECMT	VB
HRIGH	NN
LHRWWIX	VB
LCLM	VB
LHTPLL	VB
HRIGT	NNT
KNW	NN
FJWXWT	RB
EQB	IN
HRTEH	NN
KNS	NN
MQWBL	NN
MMWFKT	JJ
MALB	NNP
SGNIW	NN
PIGWR	NN
IHLWMIM	NN
RENNWTW	NN
MWBA	VB
LXC	NN
LGIJIMI	JJ
PIGWE	NN
LXM	NN
MWBN	NN
QIINI	NNP
DMGWGIWT	JJ
NIGN	VB
QLIWWLND	NNP
BELI	NNT
HTNKRWT	NN
KIFRWN	NN
KRJIS	NNT
NIGF	VB
EBRIINIM	NN
BGDTI	VB
IANQ	NNP
3271	CD
LZKWR	VB
EREWRI	NN
LZKWT	VB
BELT	NNT
EIRIIT	NNT
HIEDRW	NN
TSIIE	VB
HSKMTH	NN
IRMIHW	NNP
ZWPR	NNP
HSKMTM	NN
XIPFNW	VB
BRL	NNP
MFKILIM	NN
MTKXF	VB
EIRIIH	NN
ECMAWT	NN
LXSL	VB
AWRWN	NNP
HGIWNIT	JJ
IIXL	VB
LGBF	VB
TXWFWT	NN
TMUS	NNP
LINQR	NNP
ZRWEWTIH	NN
LGBI	IN
HWCIA	VB
HWXMCH	VB
IMMFW	VB
SJWDIW	NNP
QRWBIHM	NN
AINJIMIIM	JJ
LEMEM	VB
MCJBRWT	JJ
PTXI	NNT
BRD	NNP
RIIMWN	NNP
JWRQIWT	JJ
LNGRT	ZVL
GWPNI	JJ
LHFTKNE	VB
NZEQ	VB
23	CD
BIWRWQRJ	NN
LIQWI	NN
MMTIN	VB
HTHWWH	VB
MFMEWTIT	JJ
SIEWDI	JJ
ARSNL	NNP
MWEILH	JJ
MXMIRH	JJ
SWRIH	NNP
HARH	NN
28	CD
MWRDI	NNT
HARD	NNP
yyDASH	yyDASH
IFNIM	JJ
61	CD
62	CD
63	CD
IIMCAW	VB
MQIP	JJ
66	CD
67	CD
68	CD
LHTXIL	VB
SRGL	NN
MGPWN	NN
ETIRH	NN
HSTBRWT	NNT
ZBL	NN
MIJRAN	NNP
BXIRTW	NN
XILWNI	JJ
BXIRTH	NN
ZEMM	NN
FGWIWT	JJ
QBENW	VB
EMITIW	NN
NIRIT	NNP
PICWII	NNT
AQLIM	NN
MQIPH	JJ
SJLINISJIT	JJ
WAN	NNP
632	CD
NXWC	JJ
MFIMTW	NN
QARN	NNP
LHTGBR	VB
NXWM	NNP
QLIPRS	NNP
QARD	NN
BRIAN	NNP
TWKN	NNT
HWBEH	VB
TWKL	VB
BRIAH	JJ
SIKM	VB
SIKN	VB
BKIR	JJ
MFRWT	NN
PSXH	VB
MGIJWLW	NNP
IHWDI	JJ
NXMD	JJ
3.1	CD
XWPFH	NN
XWPFI	JJ
MGH	NNP
MLKTXILH	RB
FBIM	NN
CWRPW	VB
ERBIM	NN
EBWT	JJ
LESWQ	VB
QFRIM	NN
AIBDH	VB
HCHRWTIW	NN
EBWR	IN
IWFBWT	VB
MFKWRWT	NN
BITIIM	JJ
BWZR	NNP
XWTMH	NN
LIBRJI	NNP
IFMIE	VB
FBIL	NN
HCHRWTIH	NN
QLLWT	NN
QWLXWZ	NN
XWQIWT	JJ
NXMN	NNP
NIBWLI	NNT
LIMPH	NN
EITWNAIM	NN
TIKWNIIM	JJ
MLMJH	RB
MLMILIAN	NNP
LIDS	NNP
EITWNAIT	NN
TTRWM	VB
I.	NNP
CBEWNIIM	JJ
LSLAW	NNP
HCTH	NN
NFAL	VB
LFWWA	RB
IS	NNP
LEBWR	VB
LEBWT	VB
IM	NN
IN	NN
NFAR	VB
PANI	NNP
TTXRH	VB
NFAW	VB
ID	NN
QWMPLQS	NN
IF	VB
LHMLIC	VB
MFAIWT	NN
NWTRW	VB
GIBSWN	NNP
QRIATW	NN
QWLQJIWWI	JJ
GWRBCWB	NNP
QIISI	NNP
SIPRTI	VB
MTW	VB
RKIFWT	NN
NWTRH	VB
GALAJASRI	NNP
IASR	NNP
QPKWT	ZVL
LNTQ	VB
ARIAL	NNP
PWJRIM	VB
MAXWR	MOD
XLWQI	NNT
XLWQH	NN
RKBT	NN
XLWQT	NNT
TDIAWF	NNP
GJAWT	NN
SIWRI	NNT
RWNAL	NNP
XBRTI	JJ
NCRT	NNP
TGWBWTIH	NN
BLPWR	NNP
SBLNWT	NN
FDIM	NN
AXHUC	NN
MIKRZ	NN
SXP	NN
SXR	NN
TKNITW	NN
PSIMIT	JJ
GIFTW	NN
HFERWT	NN
MMFLTIWT	JJ
TWRNWT	NN
ABIBIT	JJ
XINWKIIM	JJ
MPXDT	VB
FARIT	NNT
IAHBW	VB
WWRWDH	JJ
LHFLIM	VB
NGML	VB
FWABIM	VB
RWQMN	NNP
RWMNJIM	JJ
ESWQ	VB
SISLI	NNP
ZQWQH	VB
XWSL	VB
XWSM	VB
NSIEH	NN
IXDF	VB
EQRWNI	JJ
HEWNH	RB
FXUL	NNP
KPRH	NN
MTNHLT	VB
HWNX	VB
SIQRN	VB
HWEBR	VB
HWNW	NN
MHWDQT	JJ
XWSR	NNT
QRWIP	NNP
RWWXI	JJ
HAFIM	VB
ZKIWN	NN
LHTGWNN	VB
MFXDIM	VB
PWINJ	NNP
LWWRQWZN	NNP
MNHIGIM	NN
FRIPWT	NN
FINI	NN
FINH	VB
ARMWN	NN
MNHIGIW	NN
NBXRIM	NN
KNRAH	RB
NIGWDIM	NN
NRGZIM	JJ
HTIIFBH	VB
XBRTN	NN
NSGIR	VB
LBKM	NN
TDMIT	NN
KLB	NN
MERKWNIM	NN
MKSWT	NNT
NTBQF	VB
RWMAN	NN
AINJLQJWAL	NN
FRIRWTI	JJ
LWWTR	VB
HPGINW	VB
11,005	CD
LHSTDR	VB
MWSIQLI	JJ
BRBRH	NNP
SMKWTW	NN
XWCPNIT	JJ
LIWWI	NN
LHTMQD	VB
TWSPWT	NN
TNUKIT	JJ
HPIKH	NN
NIGNH	VB
PNIMIWT	NN
TRM	VB
HLWWAH	NN
IHPWK	AUX
HGNTI	JJ
NFBRH	VB
QUQ	NN
AFUL	NNP
AIAN	NNP
DWMH	JJ
ARWNWT	NNT
MNWRH	NNP
MTBWNN	NN
CBAIIM	JJ
MEKBT	VB
IWELW	VB
NKFLH	VB
LIIQR	VB
LIIQS	NNP
HLKH	NN
FILFWM	RB
LBWTNW	NN
BHDGFH	RB
MCIINIM	VB
MLAKWT	NN
DIRQJWRIWN	NN
HLKW	VB
MWSRARH	NNP
FIFH	CD
AXBAR	NNP
MBLBLIM	VB
JMWNIM	VB
NPTLIM	JJ
FBWEIWT	JJ
RWQI	NN
LWQAL	NN
NHLIM	NN
ADIRH	JJ
ZWLTW	NN
HCJWPPW	VB
MQRIM	NN
6691	CD
HTQFRW	VB
KTWB	VB
HWPQW	VB
HNPQT	NNT
DRWF	VB
HWFIJW	VB
XWIBW	VB
WEIDT	NNT
AJRQJIWWIM	JJ
MIICRIM	VB
DRWM	NN
QRWNIT	NN
DRWR	NNP
QTWLI	JJ
CILWMI	NNT
MFTRE	VB
LHIENWT	VB
HCBTM	NN
HWDEH	NN
TEFIITI	JJ
APWDWT	NNT
753	CD
NFDDH	VB
ELH	VB
ELI	IN
RDP	VB
MIMRH	NN
LHIFME	VB
XLFWT	NN
IWFRW	NN
AWRKW	NN
DRGIM	NN
NWZPT	VB
HTREMW	VB
ISKIM	VB
FMFWN	NNP
23.90	CD
RDI	NNP
ELW	VB
LHIFMR	VB
NTIB	NNT
LEGH	NN
FBTI	NNP
MGRFW	NN
FBW	VB
LEGM	NN
PLIJT	NNT
FBT	NNP
TWMIJI	NNP
FBX	NN
MDIM	NN
MDWRGT	VB
PWFRT	JJ
MLWWH	VB
MAXWRI	IN
MMCIA	NNT
MSQNH	NN
MGRFM	NN
HWKRXW	VB
PLIJH	NN
PLIJI	NNT
PWSJ	NNP
SMLI	NNT
FBTW	NN
20.30	CD
IIASRW	VB
PWJR	VB
MICMC	VB
CIMRIM	NN
MXIR	NN
MNWXTI	NN
ICRNIM	NN
MMWNH	NN
PANL	NN
MKBIM	NN
BIEWR	NNT
MKBIH	NN
NWSEIM	NN
MXLCT	VB
AHBH	NN
4.2	CD
HZDMN	VB
SGR	NN
ZRWEM	NN
CIBWRIT	JJ
DRIQS	NNP
MPTIEWT	VB
5	CD
SGL	NNP
ZRWEW	NN
SGN	NNT
AHBT	NNT
HFIG	VB
LHWFIE	VB
NTWNWT	VB
HFIB	VB
HZMNH	NN
TWMKI	NNT
ARCIFRALI	JJ
MIWEDT	VB
NQLET	VB
PRIFMN	NNP
ICA	VB
XZQWT	JJ
DWQJWR	NN
LFPWJ	VB
CNE	NN
QWMPQJ	NNT
FIXQ	VB
TWRIM	NN
ICR	VB
GLWIH	JJ
NQLEH	VB
TWMKT	JJ
MPGEI	NNT
FLJT	JJ
HFTNH	VB
BIRDSLI	NNP
FLJW	VB
PFE	NN
XFIPH	NN
MPQXT	VB
FWABT	JJ
AISLMI	JJ
NICXWNH	NN
DTIWT	JJ
DXQ	VB
DXP	VB
25.90	CD
PFR	NN
MRTP	NN
DXH	VB
KWBEIM	NN
BMFK	IN
PRICT	NNT
FLJH	VB
LHRWG	VB
PQID	NN
ARWKIM	JJ
NRKFH	VB
MIIDI	JJ
FIXI	NNT
MFIKT	NNT
BWSRIWTW	NN
MWJEH	JJ
GDWLTW	NN
GFRIM	NN
GDWLTH	NN
NFBRWT	VB
MIISR	VB
PRIS	NNP
NGWHWT	NN
MTQDM	JJ
AWPCIH	NN
ZCUL	JJ
WWADINGR	NNP
CIPWR	NNT
HXRPT	NNT
GLEDI	NNP
ANWFIWTM	NN
RFMIIM	JJ
SIRWBH	NN
FLIFI	JJ
TLMIDWT	NN
LHEIR	VB
AGRWPW	NN
CWWXIM	VB
HDWRIM	JJ
MLXMT	NNT
APIDMIWLWGIIM	JJ
LHWQIR	VB
RWNI	NNP
MJH	NN
HTWWDEH	VB
MPIIST	JJ
ITMKW	VB
SIPQ	VB
SIPR	VB
GIM	NNP
GIL	NNT
PWELIM	NN
DRMAJI	JJ
GII	NNP
MLXMH	NN
AHB	VB
NPL	VB
IERIM	NN
AZBIW	NNP
PRANQ	NN
MFWLLT	JJT
NPJ	NN
JIPS	VB
AHH	NN
NPF	NN
EWLMWT	NN
QWMWNIZM	NN
ITRH	RB
JIPH	NN
RICH	NN
NSWG	VB
NPT	NNT
MENG	VB
CDN	NN
AGWUI	NNP
TFBC	NNT
IWZMWT	NN
QNIWT	NN
EL	IN
QWDMWT	JJ
XIZBALLH	NNP
LWQRI	NNP
IRIBTH	NN
AIRPN	NNP
HTNKLWT	NNT
TBIEWTIH	NN
IXTMW	VB
BEJW	VB
NTQEW	VB
MTGEGEIM	VB
SAQRMNJW	NNP
LHFKIX	VB
BNIINIM	NN
TBWSTW	NN
FMIR	NNP
MSKI	NNT
PLD	NNP
FMIM	NN
GZRTH	NN
QPIJL	NNP
ICWRP	VB
ABLWT	NN
HSQT	NNT
MTXIIB	NN
KPR	NNT
TKWNH	NN
FITQW	VB
QRIRH	JJ
CWEQIM	VB
MWQCH	VB
HAFMWTIW	NN
JWRNIRIM	NN
TXINTW	NN
KPH	VB
KPI	IN
MILIWNI	CDT
LHSTWBB	VB
KPL	NNT
MPSIQIM	VB
HBIEW	VB
LHCIE	VB
MQCTH	NN
HARIKH	VB
FLIJTNW	NN
IRWFLMIIM	JJ
MWDH	VB
MDINAIM	NN
MKWPPT	VB
MWDL	NN
FRIJWT	NN
MBWGRIM	NN
MWDD	NNT
MWDE	VB
RCWI	JJ
LQBWE	VB
IALC	VB
DISNI	NNP
CNWEH	JJ
MEWBDWT	JJ
LFNWA	VB
HRNJALS	NNP
KMEJ	MOD
ABINR	NNP
TEWDWT	NNT
LPQWD	VB
NWLDH	VB
MFLWX	NN
TLMIDI	NNT
EWRKIM	VB
XWQTI	JJ
NDIRH	JJ
RKWFW	NN
BWDHISJIT	JJ
LHLWM	VB
SPRWTIWT	JJ
SIMNI	NNT
JRIJWRIALIIM	JJ
HWMWR	NN
KWHN	NNT
LACIW	NNP
AMIN	NNP
LRENN	VB
ER	VB
NCIGWT	NN
SPIR	NNP
IPNH	VB
MFPIEWT	VB
NXLIT	VB
IIFQ	VB
TFUT	NNP
QBRI	NNT
GWNS	NNP
QBRW	NN
GWNN	NNP
DWUXWT	NN
HSTIIMW	VB
PRMIWT	NN
HPTIEW	VB
MWDRNIT	JJ
XWRXH	NNP
NICXW	VB
MTERBIM	VB
HTRAH	NN
KTIBT	NNT
AXIDH	JJ
AMNWIWT	NN
SWCIAL	JJ
JIPLW	VB
QIBWCIWT	JJ
NICXL	VB
PGM	NN
NICXH	VB
DINACI	NNP
DWRSWN	NNP
BELWTW	NN
RFMT	VB
SQNDINWWIT	JJ
MSIJIM	VB
XRDWT	NN
XSRWT	JJT
BNIIT	NNT
MCWQH	NN
6891	CD
SQNDINWWIM	JJ
LHTXKM	VB
QLIBWRN	NNP
THPWK	AUX
RFMI	JJ
MRIDWR	NNP
RISQI	NNP
TICWR	VB
HAPJ	NNP
5.0	CD
5.1	CD
LWWIH	NN
5.5	CD
MDUA	NNP
MWJEIT	VB
DIWQNAWT	NNT
MZIZH	VB
MITQPH	NN
RIFQWLNIQ	NNP
NAILH	NNP
MWJEIM	JJ
HARXH	NN
KMWBN	RB
ATNIWT	JJ
AITNH	JJ
NWTX	VB
AIZH	WDT
GRMNIIM	JJ
MMSD	NN
AWSRT	VB
BQBWQI	NNT
INWKW	VB
ILDIW	NN
MRFIM	VB
HQNIWT	NN
FWLIIM	NN
TTKNS	VB
CACA	NN
DWPQ	NN
TRWMWT	NN
AWLIMPIADWT	NN
IIMFKW	VB
SIMN	NN
GRIN	NN
AIZW	WDT
FTILIM	NN
LHPQID	VB
TBE	VB
HCLXWTIW	NN
TWMK	VB
EMIDR	NNP
MSRH	VB
NPLH	VB
IDIDIW	NN
TWMS	NNP
CRLSJWN	NNP
ALXNDRW	NNP
HAFMWT	NN
MAMINH	VB
AMIR	NNP
PLFTINIIM	JJ
AXIM	NN
MEWDD	JJ
MXLIJIM	VB
XWLWNIM	NN
AXID	JJ
ALMWLZINW	NNP
MBRQ	NN
NWFA	NN
LINH	NNP
HDGIFW	VB
HSPIQ	VB
AXIW	NN
LINC	NN
GWBR	VB
NWBEIM	VB
MCJIIN	VB
XZW	VB
XZQ	JJ
XZR	VB
HRGFH	NN
PJRIWJ	NN
GZENI	JJ
AILWCI	NNT
LDBR	VB
MIIBAT	VB
MIFNHW	PRP
HRGFT	NNT
HWDXW	VB
MCJIIR	VB
XZH	NN
FWTPWIWT	NN
MIWMN	JJ
AGDT	NNT
PALS	NNP
L	IN
XLIPIN	NN
MIDRDR	VB
QWPH	NN
AGDH	NN
LEMWD	VB
TTXTN	VB
HWZKRW	VB
MINIWT	JJ
RIMWN	NNT
HQLJH	NN
XQIIN	NN
SBLNI	JJ
HWGF	VB
JAJSWAW	NNP
HTGWRR	VB
SNIGWRIWT	NN
XIWNIIM	JJ
HSEIRH	VB
KWXWT	NN
AMITI	JJ
HQLJT	NNT
ASWRIM	VB
LXFWF	VB
TEWDT	NNT
LXFWD	VB
IWGWSLWWI	JJ
LXFWB	VB
JIST	NNT
NWBMBR	NNP
XIFWBIM	NN
AIXRH	VB
DWRIT	NNP
PRINCIP	NN
RAMASWWAMI	NNP
LXFWP	VB
ENIBH	NN
PWFEIM	NN
LBWNJIN	NNP
MKWNWT	NN
TQWE	VB
AMITIT	JJ
BTWLIM	NN
WWADI	NN
IRIIH	NN
MPEIL	NNT
ZQNI	NNT
IWZRMW	VB
WILH	NNP
TRWMT	NNT
MLXMTH	NN
WILI	NNP
LSWR	VB
MRGRJ	NNP
ESQI	JJ
ESQH	VB
ESQN	NN
XMI	NNT
MTMXH	NN
MSGRWT	NN
BECLTIIM	RB
XLWNWT	NN
QHIR	NNP
yySCLN	yySCLN
HTXIIBH	VB
AWLMWT	NNT
MWJWT	NNT
ZMNIM	NN
HFAIRW	VB
NJEH	VB
MTABL	VB
NJEN	VB
XWMR	NN
HDXH	NN
FIPWCNIQ	NN
HPNIIT	NNT
RZIN	NNP
AILWCIM	NN
AIPWA	RB
HDXT	NNT
AIMT	IN
TRWMH	NN
RWPI	NNP
EKBR	NN
AIMW	NN
AINJIMIT	JJ
ELIZH	NNP
TMIMH	JJ
TMIMI	JJT
MRNFJIIN	NNP
KINWS	NNT
HTELMWT	NN
XDIM	JJ
XDIR	JJ
KINWN	NNT
EISQIIM	NN
MWLIKIM	VB
MWBILWT	JJ
LPTWX	VB
BITM	NN
6,592	CD
FEWRM	NN
BITI	JJ
BITH	NN
SDAM	NNP
BLWBFJIIN	NNP
SJIBN	NNP
XILWQI	NNT
TQRH	NN
HQDIM	VB
LAWWN	NNP
BITW	NN
MXZWRI	NNT
LBIN	IN
TIPTR	VB
MMISIM	NN
GIREWN	NN
HWQWS	NN
HDIXH	VB
EWPRI	NNP
TLT	MOD
XLASQ	NNP
BIQFTI	VB
13.90	CD
MPTX	NN
QNDL	NNP
HSLMH	NN
QNDH	NNP
TWKNIT	NN
TLK	VB
MPTN	NNT
ALGNJIWT	NN
BELIL	MOD
yyQUOT	yyQUOT
PASIWN	NN
XIRWM	NN
LBKWT	VB
LIWWIT	VB
MRWM	NNP
TAMC	VB
SJTH	VB
LHGBIR	VB
QRAQSI	NNP
TEMWD	VB
FIDWR	NNT
NWJIM	VB
TEBWR	VB
LHGBIH	VB
PWPWLRIWT	NN
TAMR	VB
RWDPIM	NN
NLXMIM	VB
HNRI	NNP
LHDQ	VB
ZINQ	VB
JAZIMH	NNP
HSTPQW	VB
XWWIH	NN
HCXQWT	NN
QWNJRS	NNP
XWWIM	VB
ANIIT	NNT
QWWARC	NNP
BRAFIT	RB
IIAPFRW	VB
TSLX	VB
FLJWNWT	NN
IWSIPW	VB
CBEH	VB
MAHL	NN
MFNTW	NN
ARRJ	NNP
REIWNWTIW	NN
REIWNWTIH	NN
MFNTM	NN
LILWT	NN
BIJWXI	NNT
HFIBH	VB
775	CD
MFQPIIM	NN
RFWTM	NN
IIFWT	NN
EJI	NNP
IHIIH	VB
772	CD
RBW	NN
WIIJ	NNP
RBT	JJT
LIMWDIHM	NN
WIIN	NNP
NWSXT	NNT
TXZIT	NN
76	CD
IIFWB	NN
74	CD
73	CD
72	CD
RBI	NN
RBH	JJ
AWRIT	NNP
RBE	NN
KRGE	RB
IEWDKNW	VB
IIFWM	NNT
79	CD
FLWF	CD
QMBL	NNP
IMMH	NN
LBQPSPBIN	NNP
NHIH	VB
LGM	VB
ARL	NNP
WWJPWRD	NNP
LHQCWT	VB
TIHNH	VB
ATIAISJIM	NN
AZIQIM	NN
HMAN	NNP
XRIGWT	JJ
ZEIRH	JJ
LHFIA	VB
MIQA	NNP
PWNDMNJLIZM	NN
MFWM	IN
MNWCXIM	JJ
LFMF	VB
MAPIIN	NN
NTLW	VB
FWMRWN	NNP
HWERKW	VB
JL	NNP
IMLAW	VB
JI	NNP
LFMR	VB
SJJWS	NN
KWTBIM	NN
MAFRIM	VB
AHDH	NN
MWJL	VB
MSRW	VB
BRIJIM	NN
LFKTW	NN
GIBWRIM	NN
MXKH	VB
SILBIH	NNP
BRIJIT	JJ
HKRIZH	VB
ACUL	NNP
HSTPQ	VB
ASJRJGIH	NN
PIREWN	NNT
CRWRWT	NN
IAN	NNP
FXWXH	JJ
IAH	JJ
IWFBIH	NN
HWSIPW	VB
BLGIH	NNP
BLGIM	NN
TIQ	NNT
ABXNH	NN
GLGWLIH	NN
MTKNN	VB
5,000	CD
HWSIPH	VB
LHRBWT	VB
MQWMW	NN
IPTWR	VB
XTNIM	NN
LHPTIE	VB
ECBNWT	NN
TCPIWT	NN
CECWE	NN
KIKWBH	NN
AWBIIQJ	NNT
MPLGTI	JJ
MPLGTW	NN
THIH	AUX
2,162	CD
CWQR	NNP
CXWQ	NN
FLHI	NNT
CEQNIT	JJ
MJILWT	VB
HDXTW	NN
AWKLWSIIH	NN
PRWP	NN
BS	NNP
MSWIMT	JJ
HKBDT	NNT
JIRN	NNP
RIWZABWRW	NNP
GSI	NNP
BQBWQ	NN
PRWC	NNT
JIRT	NNT
TQCWB	NNT
MTQFH	VB
AWPNWE	NN
2.2	CD
AWKLWSIIT	NNT
JEWNWT	VB
2.7	CD
2.6	CD
AWLIMPIADT	NNT
EWZR	NNT
GLRIWT	NN
PRJNIWT	JJ
BEINI	IN
BEINH	RB
KWZBWT	JJ
CBAIT	JJ
NKNST	VB
NKNSW	VB
IENW	VB
IENH	NN
NKNSH	VB
EWZI	NNP
WBRAFT	NNP
SIIE	VB
HJIL	VB
SIRB	VB
KDAIWTM	NN
MHM	QW
NISIWNWTIH	NN
NTXIM	NN
DGMI	NNT
MKDI	IN
BLINQWB	NNP
FKIRWT	NN
EIRAQ	NNP
FIIKT	JJ
MHW	QW
FWJIM	JJ
NISIWNWTIW	NN
MHR	RB
XNWIWT	NN
IWXNN	NNP
AND	NNP
MFLMIM	VB
HTGLH	VB
MQWMH	NN
SIRWS	NNT
KES	NN
ANI	PRP
MQWMN	NN
MELH	NNT
LCJJ	VB
HJIG	NNP
NHGIM	NN
0591	CD
PWLMN	NNP
IPANIM	NN
9:00	CD
PNIH	NN
MWFG	NN
MFKIT	NN
MWFB	NN
MDINWT	NN
MWFA	NN
MCXIQNIM	NN
DIJRIK	NNP
MWFK	VB
HFLIJW	VB
CEIR	JJ
ALIMWTM	NN
MCWDDT	JJ
IZKH	VB
20.00	CD
PRFIIH	NN
SKNH	NN
AWRJGH	NNP
AITNIM	JJ
FWJRI	NNT
MKWNH	NN
BLWNIM	NN
JJRI	JJ
FLWXWT	NN
ABIDWT	NN
KIBDH	VB
MKWNT	NNT
ATNXTA	NN
MSGIRIM	VB
HTERBWT	NN
TSQIRI	NNT
IWFMH	VB
XNIKIW	NN
HWDETI	VB
PNIITNW	NN
TLUG	NN
KHWNTW	NN
KHWNTH	NN
KRK	VB
EWNFIM	NN
BALX	NNP
AIWWLIN	NNP
CWENIM	NN
QDWMH	JJ
MNKL	NNT
ERBWIWT	NN
EMDWT	NN
RWXWT	NN
ICIATW	NN
EDIPT	NN
IRWFLMIT	JJ
ABIH	NN
RFWMWT	VB
MFPXTNW	NN
BRIAWT	NN
HGWN	JJ
IAJH	NNP
HSTXRR	VB
NZIL	JJ
5111	CD
19.1	CD
FNINWT	NN
MEFHW	NN
TZMN	VB
MNXILI	NNT
MNWDH	VB
NKSIW	NN
MMFIK	VB
LEWMQ	RB
FPLH	NN
MERBWNIM	NN
QNIIH	NN
86.90	CD
SHUK	NN
TKWNWTIW	NN
BIQRNW	VB
TPQIDN	NN
NHRGH	VB
BIRWR	NN
LMTN	VB
GIBFH	VB
MMFIT	JJ
MASJRS	NNP
ISWRW	VB
FIBXW	VB
JKNWLWGIIT	NNT
PMLIITW	NN
IIELM	VB
9	CD
LNQWT	VB
ZWWEWT	NN
ASJRAJGI	JJ
891	CD
PSIKWLWGISJI	JJ
DIRTH	NN
IIDW	VB
AWHDIM	NN
MEDKN	VB
GWLP	NN
LDWWX	VB
MTEQF	VB
AWHDIH	NN
MTENIINIM	VB
ALJR	NNP
GWLN	NNP
GWLM	NN
XIWNI	JJ
ICPW	VB
BQWFI	RB
ECTI	NN
GWLD	NNP
BSISIIM	JJ
MEWDKN	JJ
LNDWD	VB
DINAMW	NNP
TAPWP	VB
IHMRW	VB
NPSLH	VB
PEWLWTIW	NN
MWCBIM	VB
TEBIR	VB
FIWR	NN
SWPRT	NN
BBQFH	RB
SWGRT	NNT
NXFPH	VB
FMETI	VB
RAFITH	NN
SWGRI	NNT
LHTXMM	VB
DARN	NNP
SWPRI	NNT
SWPRH	VB
MWQDMT	JJ
AWSR	VB
RISWN	NN
LHBH	NN
JWJW	NN
NFWAH	JJ
JBEWN	NNP
ZKAIWT	VB
HKNH	NN
MLAKWTI	JJ
NXFPW	VB
LBRK	VB
DMWQRJIT	JJ
LBRR	VB
MWRKBT	JJ
PIRSMW	VB
NXSK	VB
DWRI	NNP
WIIDNPLD	NNP
KWNH	VB
PILDLPIH	NNP
DWRF	VB
EWSQIM	VB
MKBD	VB
KWNS	NNT
KWNW	VB
MFTWLLIM	VB
TKZIB	VB
IDPIS	VB
PWZWT	NN
AINJLQJWALI	JJ
NIFWAIN	NN
NIFWAIM	NN
HEBRTW	NN
FXIIH	NN
IWRM	NNP
HTBJAWT	NN
LIWWTH	VB
RPWBLIQAI	JJ
ELWMIM	JJ
HGBIH	VB
DWGLT	VB
ARIZWT	NN
KRWKIM	VB
HWBAW	VB
IWRQ	NNP
AMWRIM	VB
WDAIT	JJ
NFMTW	NN
IIERK	VB
AWSAQH	NNP
GWRSIM	VB
BEIJWT	NNT
BWERT	VB
MDGRWT	NN
3.7	CD
JKNIWN	NN
EINIHM	NN
KIHNH	VB
MPWQPQ	JJ
NWDD	VB
ITBJLW	VB
MEWJR	JJ
TIKNN	VB
KHNA	NNP
37.40	CD
SBIBWT	NNT
NWEDW	VB
AHBIM	NN
LIBW	NN
CMAI	JJT
DRGT	NNT
ADWMH	JJ
LILH	NN
RCIPWT	NN
LHTENIIN	VB
BIWGRPIIM	JJ
NWEDH	VB
EIQFT	JJ
AKSNIH	NN
GILWPIN	NN
LHSTIIG	VB
HEIR	VB
941	CD
WDAI	RB
CMXIIH	NN
NFMR	VB
KWABT	JJ
BLWM	NNP
MSWGLIM	VB
MWCIA	VB
NFMH	NN
HMLCWT	NNT
NFME	VB
MTLHB	VB
WIIJNAM	NNP
HWJLH	VB
MTLHJ	VB
MQBILH	JJ
HTXDFWT	NN
HTNCLWTW	NN
HWCAW	VB
MQBILW	NN
MCATI	VB
HWJLW	VB
FQIDH	NN
HWJRDW	VB
XWBFIM	VB
SPRIW	NN
PWRC	VB
MNHGW	NN
NPILH	NN
EGILIM	NN
5,779	CD
TNEMI	NNP
GZENIT	JJ
MCMCMT	VB
QRMLIN	NNP
MQSWWL	NNP
LTWK	IN
SPRIM	NN
LLEWG	VB
JBET	NN
SALM	NNP
XILWL	NNT
91.8	CD
ZITIM	NN
MPELWT	NNT
SMWKIM	JJ
MSWJ	NNP
MLBIM	VB
MSWP	NNT
AKLWSH	NN
QREIM	NN
WWRQRS	NNP
ZNWWH	NNP
GILAIM	NN
JBEI	JJ
NWEZT	JJ
MPQDIM	NN
ILDIHM	NN
LSQR	VB
XIBH	NN
PFWJ	RB
XIBR	VB
HIRCXW	NN
ABDIH	NNP
HFBWE	RB
HIWTI	NN
IQLW	VB
RWJNBRG	NNP
FXQN	NN
TQCIBI	NNT
JRM	RB
NGIE	VB
BEIT	NNT
JRI	NNP
XLWQTH	NN
HTPTXWTH	NN
TQCIBW	NN
REIL	JJ
HIWTW	AUX
HWJL	VB
NISWIIT	JJ
JRX	VB
SIIMW	VB
IIXWS	NN
TMIKH	NN
PIWRNJINH	NNP
BWJNAI	NN
MEQWT	NNT
IICAW	VB
QWMIT	JJ
EQBWT	NN
AISLAMIIM	JJ
IIAWF	NN
MXLT	NNT
MTIIMRWT	VB
IIXWD	NN
DFA	NN
NPRFW	VB
GRMNI	JJ
FAWLH	JJ
MIEJ	VB
TXRWIWT	NN
MXLQ	NNT
APWR	JJ
AHWBH	NN
WISMWNSQI	NNP
XWLFTW	NN
ELIWNWT	NN
NMRC	JJ
SPQIT	NNT
MXFBWT	NN
MFKB	NN
NWQBT	JJ
IHPKW	VB
TWQPNWT	NN
MFKWRT	NN
BRNAR	NNP
AIJIT	JJ
MWBJXT	JJ
JRWR	NN
MKIWWN	IN
BICIM	NN
QWSIGH	NNP
MSEDH	NN
AMNWTIT	JJ
HNPT	NNT
TIQI	NNT
XSIDI	NNT
MJLIT	NNT
MQWMIWT	JJ
RWMZ	VB
MRKZWT	VB
NKS	NN
PWPWLRIIM	JJ
TPWQH	NN
MFGRI	NNT
RIXP	VB
MSEDT	NNT
QHILIIH	NN
MSIIEIM	VB
AWNIWWRSLI	JJ
IHRGW	VB
PRJIIM	JJ
FIPWR	NNT
FWWH	JJ
XDFIM	JJ
HDRKH	NN
RFMIW	NN
RFMIT	JJ
LWQS	NN
FWWA	NN
DIIWID	NNP
011	CD
012	CD
013	CD
HGDRWT	NNT
TWDETM	NN
NSEH	VB
ADWARD	NNP
FWWT	JJ
ANRCIH	NN
HDRKT	NNT
IFTQP	VB
DRKW	NN
LHTXFB	VB
QJNH	JJ
MERKWT	NNT
HBHIR	VB
MWCR	NN
HPSIQW	VB
MERBIT	JJ
MQBWL	NNP
HGRLH	NN
MXSNIT	NN
AWZNIIM	NN
FIPWJ	NN
112,000	CD
MXWWH	NN
ARWKH	JJ
DRKN	NN
DRKM	NN
MCIAWTIIM	JJ
HNXWT	NN
IDIDWTIT	JJ
MERKWN	NN
DRKH	NN
ZWRM	VB
HXZIRW	VB
MCDIQ	VB
CBINSQH	NNP
EMWDW	NN
DMWIT	JJT
LHTAIM	VB
P	NNP
NICXIT	JJ
EWBI	NN
XZWNW	NN
TQPW	VB
ZWRX	VB
ZKRNW	VB
LAZWR	VB
ALWP	NN
SBW	NN
CPIIH	NN
LAN	QW
KIFLWNW	NN
LAH	NNP
MHRH	RB
NTMK	VB
FFT	CDT
AILNH	NNP
LLQQ	VB
AXWZTW	NN
FFI	NNP
FFH	CD
NWHGWT	VB
HPIKTH	NN
LAW	MOD
MBIIMIM	VB
TINTN	VB
MECWRIM	NN
NRATH	VB
MFWNH	JJ
DTI	JJ
LHZRIM	VB
PEIL	JJ
LFKH	NN
XCWCRWT	NN
NSWTH	NN
MJRIDIM	VB
SJWDNJIM	NN
PWRXT	JJ
LFKT	NNT
ELWIWT	NNT
BRQWBIC	NNP
MWQDF	VB
FILMW	VB
PXWT	RBR
MTBRR	VB
NPIQ	VB
QLINQR	NNP
XIIQIN	NNP
JIPXW	VB
QIDR	NNP
NIFAH	VB
IIMFK	VB
MWCDQWT	JJ
NQIIH	JJ
RBWEIM	JJ
SBA	NN
LKWDWT	VB
MWPTET	VB
QBWCTW	NN
HEBIRW	VB
FMWRT	NNT
HJILW	VB
BELIH	NN
1989	CD
ZHRH	NNP
TWRMT	VB
HTELMH	VB
HTELMW	VB
IGE	JJ
BINWNI	JJ
MEFIWT	JJ
SBK	NN
MNHIGWTW	NN
HJILH	VB
SCINT	NNT
BARNSLI	NNP
CBA	NN
HTMXH	VB
AWNIBRSIJAWT	NN
HTAKZB	VB
CBE	NN
MARXIM	NN
CBI	NNP
BIRWRIM	NN
LMELH	RBR
CBR	VB
MARXIW	NN
HTAKZR	VB
CWWT	NN
MWNIJIN	NN
MAXZIHN	NN
ARGWN	NN
PJR	NNP
EFN	NN
AMADWRH	NNP
FPIGLR	NNP
FWPN	NNP
DALAS	NNP
BZQ	NNP
MEJH	NN
JIPWLIT	JJ
BNZN	NN
MPGRT	VB
QLIJH	NN
MJMWN	NN
MIXFWB	NN
LWBLIN	NNP
QLIJT	NNT
MFWERT	JJ
HTQDMWT	NN
FJPW	VB
RFTW	NN
MFBXIM	VB
MCIIR	VB
MNWSH	JJ
CMCMW	VB
MCIIN	VB
FPNIM	NN
BIRNDRH	NNP
RWMNIH	NNP
MINIH	RB
IBIA	VB
BRIXT	NNT
PARAQAN	NNP
MINIM	NN
SBIBTIWT	JJ
AWHBT	VB
IBIN	VB
MWFLM	JJ
MWFLKWT	JJ
NEZR	VB
NQIFTIWT	NN
RPIWN	NN
BRIXH	NN
LIPCIN	NNP
HWZKR	VB
MINIT	JJ
ALN	NNP
NTX	NN
MBINWT	JJ
MWFLI	NNT
ALH	JJ
ALI	IN
NTQ	NN
BIWN	NN
MPQDIW	NN
TXKWM	NN
ALA	CC
XANWN	NNP
BNQIM	NN
NTN	VB
LHTMID	VB
ALW	JJ
TFTWWH	VB
NAWMW	NN
MWNJH	NNP
ALP	CD
MDRXWB	NNT
BAIIR	NNP
HBIS	VB
DIWMA	NNP
MWULWT	NN
MTWRGMN	NN
ICIAH	NN
MFMFIM	VB
IRAH	VB
FWWIICRI	JJ
HBIA	VB
HARWWARD	NNP
XBIB	JJ
HBIE	VB
HPTEH	NN
TRGWL	NN
FRPWT	NN
NIKWR	NN
HBIJ	VB
NAFM	NN
MTMID	RB
HWWARD	NNP
PJRIWJIM	NN
QWLT	NNP
SKWMIM	NN
IWXLJ	VB
EITWNAIIM	JJ
LHTNKR	VB
LHIDRF	VB
EIQRWN	NN
NAMNH	JJ
AQWNWMISJ	NNP
QWLP	NNP
ETIRT	JJT
NXLCW	VB
LHTPRQ	VB
BANW	VB
MWMLCIM	VB
PSIQTW	NN
TLWT	NN
FIWWIWN	NN
FIXRR	VB
HRIMW	VB
ANXNW	PRP
ITLWW	VB
LRWPP	VB
MWCGIM	VB
MSEIRIM	JJ
LHTPRF	VB
TLWI	JJ
HCITH	VB
AWGNIWQ	NNP
QIPAWN	NN
KTB	NNT
7001	CD
NASRH	VB
TDWWX	VB
NWSIIR	NNP
NFRW	VB
TESWQ	VB
IAWFRW	VB
HBIAW	VB
HIIFR	RB
HBIAH	VB
MSWBKT	JJ
CEDIH	NN
QWMDI	NNP
MKFIR	NNT
XPIRWTIW	NN
HGFT	NNT
DIQJJWRH	NN
GLWT	NN
NZKR	VB
MSKMT	VB
MBJIXIM	VB
MWXM	NN
SGRIRI	JJ
MZIMTW	NN
BZKWT	IN
MMCAIHM	NN
GLWB	NNP
DRIFWTIHM	NN
LHDGIF	VB
TGDL	VB
LHTGWRR	VB
RXWQIM	JJ
NZKH	VB
IIFMRW	VB
IFPIEW	VB
TPGE	VB
IRWXM	NNP
LHGIB	VB
HTAIMW	VB
HRISWT	NN
KTBIW	NN
MJWRP	NN
IRAT	NNT
FRIQWT	NNT
HNHGTI	JJ
MARXT	VB
MARXW	NN
MBQFIM	VB
QICWNIT	JJ
MRGIF	VB
5591	CD
BLNIGRD	NNP
ICRI	NN
MLBI	NNT
XWMRIM	NN
HXLJH	NN
FRIDI	NNT
MLBD	IN
HDGIFH	VB
BJXWN	NN
PAPJIH	NNP
HPRNQ	NN
IWCR	NN
CPRIRIM	NNP
HXLJT	NNT
NEWRIM	NN
ICRW	VB
HPSD	NN
DMWQRJIWT	NN
FIRWTIM	NN
PLIFT	NNT
HQLJWT	NNT
DINMIQH	NN
DWNQL	NNP
HTIIPIIPWT	NN
XLQIIM	JJ
QICWNIM	NN
HTREH	NN
DISLDWRP	NNP
FGRIR	NN
RAFLUC	NNP
AWMR	VB
HZMINH	VB
HSKMT	NNT
ITBRR	VB
HWNGRIH	NNP
QRIAWTIHN	NN
MSTMKT	VB
NXWCIM	JJ
ANWF	NN
89	CD
AWMC	NN
HSKMI	NNT
LHLK	VB
82	CD
83	CD
MQSM	NNT
81	CD
86	CD
87	CD
LWPA	NNP
AWMH	NN
CIRIH	NN
LPRSM	VB
MJRIM	NN
BIMH	NN
HLIKIM	NN
JWHR	NNT
BIMT	NNT
MSWGL	VB
AINDIQCIH	NN
IIDIFAI	JJ
KWLN	PRP
KWLL	IN
KWLM	PRP
HPRIE	VB
KWLH	JJ
KWLI	RB
SPWGWT	VB
CRPTI	JJ
EFRT	CDT
MTPTXT	VB
MPWRZT	JJ
MIRBI	JJ
XQLAWT	NN
GBET	NNT
IFTWQ	VB
EFRH	CD
KWLW	JJ
EWRRNW	VB
AIBDW	VB
MXZIQWT	NNT
TWQP	NN
LHIPGF	VB
MZH	MOD
CHWB	NN
NWFAIM	NN
TWQM	VB
TWQN	VB
MWCIAH	VB
NWAFW	VB
NPLAIM	JJ
MFJRTI	JJ
EWRPI	JJ
HKRIEW	VB
AXWRIT	JJ
QIBLW	VB
LHCNIE	VB
GWRE	VB
MTQN	NN
AXMD	NNP
QIBLH	VB
NWBL	NNP
QJIPH	NN
NWBE	VB
SIWMH	NN
MSWIM	JJ
LIJA	NNP
MGRF	NN
MWSDI	JJ
REIWNWTIHM	NN
MTWQNWT	JJ
MEWRBWT	NN
MRWWX	NN
PITWXIM	NN
1500	CD
MASR	NN
MGDIRH	VB
KRMIAL	NNP
RFWTNW	NN
ZIIDNBRG	NNP
HELAT	NNT
PLSJIQ	NN
EIKWB	NNT
PLGI	NNT
EWMQH	NN
LRSN	VB
LJINIWT	JJ
KPRIT	JJ
EIWWTIM	NN
KC	NNP
IRTH	VB
ALTWRIM	NN
PLIQS	NNP
KF	IN
HRAH	VB
KK	PRP
SGWRIM	JJ
KI	COM
KH	RB
HWZMNH	VB
KN	PRP
KL	DT
KS	NNT
HFKILH	VB
KP	NN
KW	RB
IIGBH	VB
KT	NN
NRMSH	VB
KX	NNT
HMLCWTIH	NN
HRAL	NNP
1.4	CD
1.6	CD
1.1	CD
1.2	CD
1.3	CD
XPCI	NNT
CPCPWT	NN
MTSKLT	JJ
NEWCWT	VB
SQRIM	NN
MPGIFIM	VB
NSIGH	NN
MWSQJRIM	NN
LKRWE	VB
BLWMPILD	NNP
ARIQ	NNP
MEBIRIM	VB
LJEWN	VB
NEWCH	VB
LHXRIP	VB
TIQRA	VB
XPCW	NN
MXLWT	NN
HLIKI	NNT
MSQR	VB
SQRN	JJ
PRCWP	NN
LJEWT	VB
FGRTIT	JJ
FMWRWT	NNT
NZKWR	VB
QPRISIN	NNP
IZI	NNP
CRNR	NNP
RWBE	NN
ALIMWT	NN
MGNJIIM	JJ
XIDWFIM	NN
MRWWIXH	VB
HDRGTI	JJ
ZHIM	JJ
ABXWN	NN
MDWWX	VB
AIRWEI	NNT
HWDX	VB
HWDW	NNP
QIWM	NN
KABI	NNT
IXZQ	VB
HWDP	NNT
MWCAIM	VB
MMMN	VB
ITPWS	VB
HWDH	VB
NMCAT	VB
JWENIM	VB
NMCAW	VB
QWWI	NNT
NDXSW	VB
QLWPIM	JJ
RWBL	NN
BGD	VB
MNHIGWT	NN
MFL	NNT
PLWRIDH	NNP
AINSJINQJIM	NN
QRISJL	NNP
IBWCEW	VB
BGR	VB
MIWXSWT	VB
MTWWDH	VB
MRGIFIM	VB
FBRAWWI	NNP
ITMWDD	VB
MFIX	NN
AWQJWBR	NNP
ALWMWT	NNT
BQFH	NN
ZLMN	NNP
EMSI	NNP
SQIRWT	NN
MFIJ	NNT
MTPTLT	JJ
MFPJN	NN
XWLIH	NN
MFPJI	JJ
RWBIM	NN
MFIM	VB
MFIB	VB
MXFBIM	NN
MFIG	VB
NIHWLH	NN
IIFLXW	VB
GPN	NN
DNDI	NNP
ZREWNIM	NN
QJINIM	NN
IXWDIIM	JJ
NHPWK	VB
THH	VB
NWPIT	JJ
MQSIQAI	JJ
WWTIQI	NNT
MXQRW	NN
DBQW	VB
NRQXIM	VB
NIN	NNP
LPQD	VB
NIB	NNP
PINIQS	NNP
LIIPCIG	NNP
HCGWT	NNT
TWKNWT	NN
TAIM	NN
MWTRWT	NN
KISAW	NN
HLAH	RB
DBQI	NNT
NIW	NNP
WWIIJNAM	NNP
INQIM	NN
XDFWT	JJ
HTLWCCW	VB
FDD	VB
FDH	NNT
XBRTIIM	JJ
PNIMIT	JJ
SMJH	NN
WWLJ	NNP
FDR	NN
032	CD
TMIKWT	NN
031	CD
036	CD
035	CD
PRWQWPIIB	NNP
MWEDP	JJ
TWKNIWTIW	NN
QJLW	VB
HWBJXH	VB
NMKRW	VB
MALP	JJ
ALIZBT	NNP
NMKRH	VB
QWCR	NNT
FWBINIZM	NN
MFMEWT	NN
MWEDI	NNT
HBRIQ	VB
MPQXIM	VB
NXFBT	VB
TKWWN	VB
ANJWNIW	NNP
EFR	CD
BLFIM	NN
EFW	VB
EFH	VB
HNXNW	VB
TRWPWT	NN
MQWWH	VB
AGMIM	NN
LIBRH	NN
TRGILI	NNT
MGALWMAN	JJ
NJTH	VB
MTAIMIM	JJ
INWAR	NNP
MFXRIM	VB
MARJIN	NNP
HTELLWT	NN
MFPJW	NN
LCD	IN
HSTIIGWT	NN
LEIL	RB
GWPIM	NN
HTBFRNW	VB
LCH	NNP
NICNIM	NNP
SWPH	NN
SWPI	JJ
LFIM	VB
MCDIQH	VB
RX	NNT
BASJN	NNP
BRIJIIM	JJ
NHIRIM	JJ
BILWI	NN
AINTIPADH	NN
SWPX	VB
SIWR	NN
HBRAT	NNT
SWPR	NN
IDINW	NN
SWPW	NN
2000	CD
XWBB	NNT
CAWFSQW	NNP
MILH	NN
WWLSJWN	NNP
PGANI	JJ
HBRAH	NN
FMRNI	JJ
QIIMWT	JJ
04833280	CD
NPGF	VB
NPGE	VB
CWWTIM	NN
NTIBWT	NN
MWZRWT	JJ
NPFIIM	JJ
NKNE	VB
DIBWR	NN
IER	NN
XSIDIM	NN
NEIMH	JJ
QICN	NNP
NKNS	VB
IEL	NNP
XSIDIW	NN
FJWJGARJ	NNP
MSTBR	VB
EIQRIT	JJ
MCXIQ	JJ
IED	NN
DISQWNJ	NNP
PINSQI	NNP
MARGNIM	NN
HRKBT	NNT
CDM	NN
ASNT	NNP
CDI	NNT
HIGIWN	NN
TELWLI	NNT
CDW	NN
MXWFB	JJ
CDQ	NN
PLA	NN
SIWE	NN
MLKWTIT	JJ
PLJ	VB
MTIIXSIM	VB
MNTH	VB
WITWR	NN
FJRI	NNT
FJRN	NNP
DWMIW	NN
XLWPIWT	JJ
MRPAH	NN
MDWIQT	JJ
BXR	VB
TIAR	VB
KTIBH	NN
PRSJ	NNP
PRSI	JJ
PRSH	NN
PRSM	VB
EINI	NNT
DWMIH	NN
MJBXIM	NN
SWLIH	NN
FKIX	JJ
DWMIM	JJ
NWCWT	NN
SPRDI	NN
MWESQIM	JJ
TLMIDIW	NN
MXQRIIM	JJ
TLMIDIM	NN
LHIQBR	VB
NEWT	VB
TMWNWTIW	NN
BDIWQ	MOD
NMKRWT	VB
100,000	CD
NXQRIM	VB
MTX	NN
ICJMCM	VB
LWWIINI	NNT
EIIP	JJ
ALBWM	NN
QPCH	VB
QIBH	NN
QIBL	VB
MTPRS	VB
MAWFPZWT	VB
PRWSJ	NNP
MTH	VB
MTI	QW
MTN	NN
FKJR	NNP
HSITW	VB
BLGIT	JJ
CNCNT	NNT
RWPA	NN
MTPRC	JJ
MINKN	NNP
HTRXFW	VB
LICNIM	NN
ARZ	NNP
ADWMWT	JJ
ARC	NN
ARD	NNP
QBWRTW	NN
HWPKIM	VB
LTETE	VB
TPR	NN
TQDIMIM	NN
MWJI	NNP
NICLIM	VB
NCIT	JJ
MILIJNJIWT	NN
MWJB	VB
GILAI	NNT
AFTW	NN
NCIB	NNT
IBXRW	VB
NCIG	NNT
HKRIZW	VB
SICILIH	NNP
MWGBLT	JJ
WICMN	NNP
MWJW	NN
KRWNI	JJ
CDDIT	JJ
IWCQIM	VB
SKSWKI	NNT
PWLIJIQAIM	NN
NWEC	VB
LHTRFM	VB
1986	CD
MKWBD	JJ
FLIJT	NNT
NWQPT	VB
PIRSJNRIDR	NNP
LPCWT	VB
EDNH	NNP
DMWQRJIH	NN
GINTH	VB
DMWQRJIM	NN
EQWRIM	NN
MFTPWT	VB
MRTQT	JJ
EWBRIM	VB
NBLEIM	VB
MSIKH	NN
HFMDT	NNT
MTPRCWT	NN
SGNWNWT	NN
MIWTR	JJ
FIXQNW	VB
MKFWR	NN
HKPFT	NNT
XDIFWT	JJ
IEDIM	NN
HTGLEW	VB
IEDIH	NN
MKFWL	NN
7891	CD
BTXILH	RB
CRIKWT	VB
EDINIM	JJ
HSTKSKNW	VB
ICRNI	NNT
HWMNISJI	JJ
APWA	RB
AMTISJ	NNP
ZKWIWTIH	NN
111	CD
GQSWN	NNP
IDIW	NN
119	CD
APWS	NN
SWCIALIZM	NN
JLWWIZIWNIT	JJ
RKWF	NN
TLWFIM	NN
MAWPQT	JJ
SKSKWK	NN
NRAIT	VB
MTRISIM	VB
MZRET	NNP
MTKWNNT	VB
MTWKNNIM	JJ
XTIMT	NNT
HISJWRI	JJ
MWSLMI	JJ
MTWQN	JJ
DWX	VB
TBERH	NN
MCBIEI	NNT
IPTX	VB
SPWRJIWWIT	JJ
FWFLT	NNT
LBNW	NN
FWWDIM	NN
HNNW	PRP
KNIST	NNT
KNISH	NN
IEBWD	VB
MWJLW	NNP
JIRGWBISJH	NNP
IJENW	VB
MWJLT	VB
EWBDWT	NN
EWTRIM	NN
RWWXIWT	NN
SXWRWT	NN
AKZR	JJ
LHMTIN	VB
IWNIIJD	NNP
NWFAT	JJT
MFTXRRWT	VB
ELWLIM	VB
MQLXT	NN
HWCAH	NN
QWLJ	VB
HWCAT	NNT
NAMNI	NNT
QWLW	NN
DEWT	NN
QWLQ	NNP
QWLR	NNT
QLIJTM	NN
NWFAI	NNT
NWFAH	NN
34,028	CD
MXZR	NN
GWRAL	NNP
LHGIE	VB
LHGID	VB
LHGIF	VB
FLFWT	NN
HERKH	NN
FIRIM	NN
JWPLH	VB
MTPTXWT	JJ
TQCIBIIM	JJ
HQPAH	NN
FIRIT	JJ
KTBIM	NN
MBWJXIM	NN
JWPLW	VB
MBWJXIH	NN
RIINGRS	NNP
FHIIH	NN
MELLI	NNT
MFMFT	VB
HTENIIN	VB
LWRD	NNP
HCBET	NNT
AINJWNCIH	NN
HQPAT	NNT
LWRM	NNP
SPCIPIWT	JJ
LWRH	NNP
PWNQCIH	NN
KIKRWT	NN
TTPZR	VB
JWNH	NN
DWL	NNP
HCBEH	NN
MSWIG	JJ
BWLGRI	JJ
RXBWT	NNT
LQNWT	VB
ASWPT	NNT
KWRT	VB
TMWTH	NN
TAILND	NNP
FWWRCQWP	NNP
IIXWDIWT	JJ
PIIBWRIJ	JJ
TGFIM	VB
AGRSIWWIT	JJ
MJPLT	VB
MKNH	VB
MKNI	JJ
AITN	NNP
IGBILW	VB
AITM	NNP
MIWZIQL	NN
TBIEWT	NN
ZRIQWT	NNT
FNTI	JJ
RDWMIM	JJ
MFGIM	NN
MTNWT	NN
ILIDI	NNT
LECWM	VB
LHIMCA	VB
RIALIT	JJ
LECWR	VB
MNGNWNIM	NN
200,000	CD
MDWBRT	JJ
TIAWRJIT	RB
HQIM	VB
ZIQH	NN
WWIKWX	NN
QCBAWT	NNT
MEWRER	JJ
HPQIEW	VB
GWAIF	NNP
MTPRQT	JJ
DWRSNI	JJ
KHWNH	NN
FINAH	NN
XMH	JJ
HTNQFWIWT	NN
QWALICIWT	NN
XITTW	NN
RKIFT	NNT
ZIKTH	VB
MIJTW	NN
XWGIM	NN
IESWQ	VB
ATRI	NNT
MSTKMWT	VB
SWBIIJIT	JJ
LHTPTX	VB
RKIFH	NN
4,677	CD
MWXLFIM	JJ
KLWMR	RB
IIFPK	VB
TQDIM	NN
PTRWN	NN
ZKRWN	NN
ZWKH	VB
TNWBH	NNP
PLAJ	NNP
EWBRT	VB
29.9	CD
HEZ	VB
ZWKR	VB
BRZLIWT	NN
ZKWT	NN
CIIT	VB
IAKLW	VB
ZKWR	NN
NFIA	NN
PISI	JJ
CHRIM	NN
DWRFIM	NN
MFTMFT	VB
MAIIMIM	VB
MFWKNEIM	VB
WLSJWN	NNP
FERIM	NN
NFIM	NN
IARGN	VB
HKTMH	NN
MPXIDH	VB
PTRH	VB
NFIT	JJ
HTEWRRW	VB
PILLW	VB
LPLWJ	VB
MXWZIWT	JJ
MELWT	NN
